Release_Date,Rank,Movie_Title,USD_Production_Budget,USD_Worldwide_Gross,USD_Domestic_Gross,USD_Profit,Decade
1915-08-02,5293,The Birth of a Nation,110000,11000000,10000000,10890000,1910
1916-05-09,5140,Intolerance,385907,0,0,-385907,1910
1916-12-24,5230,"20,000 Leagues Under the Sea",200000,8000000,8000000,7800000,1910
1920-09-17,5299,Over the Hill to the Poorhouse,100000,3000000,3000000,2900000,1920
1925-01-01,5222,The Big Parade,245000,22000000,11000000,21755000,1920
1925-12-30,4250,Ben-Hur,3900000,9000000,9000000,5100000,1920
1927-12-08,4630,Wings,2000000,0,0,-2000000,1920
1929-01-02,5141,The Broadway Melody,379000,4358000,2800000,3979000,1920
1930-01-01,4240,Hell's Angels,4000000,0,0,-4000000,1930
1931-12-31,5043,Mata Hari,558000,900000,900000,342000,1930
1933-07-04,5017,King Kong,672000,10000650,10000000,9328650,1930
1933-09-02,5234,She Done Him Wrong,200000,2000000,2000000,1800000,1930
1933-09-03,5120,42nd Street,439000,2281000,1438000,1842000,1930
1934-01-01,5154,It Happened One Night,325000,2500000,2500000,2175000,1930
1935-06-09,5025,Top Hat,609000,3202000,1782000,2593000,1930
1936-05-02,4738,Modern Times,1500000,165049,163245,-1334951,1930
1936-06-26,4768,San Francisco,1300000,5273000,2868000,3973000,1930
1936-10-20,4814,"Charge of the Light Brigade, The",1200000,0,0,-1200000,1930
1937-12-21,4756,Snow White and the Seven Dwarfs,1488000,184925485,184925485,183437485,1930
1938-01-01,4570,Alexander's Ragtime Band,2000000,4000000,4000000,2000000,1930
1938-01-01,4693,You Can't Take It With You,1644000,4000000,4000000,2356000,1930
1939-01-01,4712,Mr. Smith Goes To Washington,1500000,9000000,9000000,7500000,1930
1939-08-25,4447,The Wizard of Oz,2777000,33754967,33711566,30977967,1930
1939-12-15,4248,Gone with the Wind,3900000,390525192,198680470,386625192,1930
1940-01-01,4556,Boom Town,2000000,9172000,9172000,7172000,1940
1940-01-01,4783,Rebecca,1288000,6000000,6000000,4712000,1940
1940-11-13,4524,Fantasia,2280000,83320000,83320000,81040000,1940
1941-10-28,4789,How Green Was My Valley,1250000,0,0,-1250000,1940
1942-08-13,4969,Bambi,858000,268000000,102797000,267142000,1940
1942-11-16,5283,Cat People,134000,8000000,4000000,7866000,1940
1943-01-23,4839,Casablanca,1039000,10462500,10462500,9423500,1940
1943-12-24,4457,A Guy Named Joe,2627000,5363000,5363000,2736000,1940
1944-01-01,4515,Bathing Beauty,2361000,3500000,3500000,1139000,1940
1944-01-08,3949,Wilson,5200000,2000000,2000000,-3200000,1940
1945-01-01,4530,The Valley of Decision,2160000,9132000,9132000,6972000,1940
1945-01-01,4785,The Lost Weekend,1250000,11000000,11000000,9750000,1940
1945-10-31,4716,Spellbound,1500000,7000000,7000000,5500000,1940
1946-01-01,4327,It's a Wonderful Life,3180000,9576159,6600000,6396159,1940
1946-01-01,4545,Notorious,2000000,24464742,24464742,22464742,1940
1946-11-21,4533,The Best Years of Our Lives,2100000,23600000,23600000,21500000,1940
1946-12-31,3845,Duel in the Sun,6000000,20400000,20400000,14400000,1940
1947-01-01,4557,Gentleman's Agreement,2000000,7800000,7800000,5800000,1940
1948-01-01,4260,The Pirate,3700000,2956000,2956000,-744000,1940
1948-01-01,4361,Red River,3000000,9012000,9012000,6012000,1940
1949-01-01,4695,She Wore a Yellow Ribbon,1600000,5400000,5400000,3800000,1940
1949-01-01,4857,Sands of Iwo Jima,1000000,7800000,7800000,6800000,1940
1950-02-15,4434,Cinderella,2900000,263591415,85000000,260691415,1950
1950-05-17,4255,Annie Get Your Gun,3768785,8000000,8000000,4231215,1950
1951-02-23,3593,Quo Vadis?,8250000,30022000,30000000,21772000,1950
1951-03-07,4797,Strangers on a Train,1200000,7000000,7000000,5800000,1950
1951-07-28,4419,Alice in Wonderland,3000000,0,0,-3000000,1950
1951-09-18,4666,A Streetcar Named Desire,1800000,8000000,8000000,6200000,1950
1951-09-24,4517,Show Boat,2300000,11000000,11000000,8700000,1950
1952-01-01,5009,High Noon,730000,8000000,8000000,7270000,1950
1952-10-01,4166,The Greatest Show on Earth,4000000,36000000,36000000,32000000,1950
1952-10-04,4468,Singin' in the Rain,2540000,7200000,7200000,4660000,1950
1953-01-21,4788,Niagara,1250000,2500000,2500000,1250000,1950
1953-05-02,4162,Peter Pan,4000000,87400000,87400000,83400000,1950
1953-05-08,4692,From Here to Eternity,1650000,30500000,30500000,28850000,1950
1953-06-13,5227,"The Beast from 20,000 Fathoms",210000,5000000,5000000,4790000,1950
1953-09-16,3969,The Robe,5000000,36000000,36000000,31000000,1950
1953-10-04,5018,House of Wax,658000,23800000,23800000,23142000,1950
1954-01-01,3999,The Egyptian,5000000,15000000,15000000,10000000,1950
1954-07-28,4959,On the Waterfront,910000,9600000,9600000,8690000,1950
1954-12-23,3973,"20,000 Leagues Under the Sea",5000000,28200000,28200000,23200000,1950
1955-03-10,4798,The Trouble With Harry,1200000,7000000,7000000,5800000,1950
1955-12-31,4705,The King’s Thief,1577000,0,0,-1577000,1950
1956-01-01,3853,War and Peace,6000000,12500000,12500000,6500000,1950
1956-01-01,4119,Moby Dick,4500000,10400000,10400000,5900000,1950
1956-01-01,4177,Trapeze,4000000,14400000,14400000,10400000,1950
1956-01-01,4856,Love Me Tender,1000000,9000000,9000000,8000000,1950
1956-02-16,4310,Carousel,3380000,3220,0,-3376780,1950
1956-05-10,3020,The Ten Commandments,13500000,80000000,80000000,66500000,1950
1956-10-17,3835,Around the World in 80 Days,6000000,42000000,42000000,36000000,1950
1956-11-19,5067,Shichinin no samurai,500000,271736,271736,-228264,1950
1956-12-01,4455,Diane,2660000,0,0,-2660000,1950
1956-12-23,4804,The Wrong Man,1200000,2000000,2000000,800000,1950
1957-01-01,4015,A Farewell To Arms,5000000,11014685,11000000,6014685,1950
1957-04-13,5152,12 Angry Men,340000,0,0,-340000,1950
1957-12-18,4337,The Bridge on the River Kwai,3000000,33300000,33300000,30300000,1950
1958-09-20,4348,Cat on a Hot Tin Roof,3000000,17570324,17570324,14570324,1950
1959-01-01,4016,Solomon and Sheba,5000000,11000000,11000000,6000000,1950
1959-01-01,4274,The Nun's Story,3500000,12800000,12800000,9300000,1950
1959-03-29,4440,Some Like it Hot,2883848,25000000,25000000,22116152,1950
1959-11-18,2802,Ben-Hur,15000000,73000000,73000000,58000000,1950
1960-01-01,4171,Exodus,4000000,21750000,21750000,17750000,1960
1960-01-01,4347,The Apartment,3000000,24600000,18600000,21600000,1960
1960-01-01,4357,Elmer Gantry,3000000,10400000,10400000,7400000,1960
1960-07-10,3151,Spartacus,12000000,60000000,30000000,48000000,1960
1960-10-24,3185,The Alamo,12000000,7900000,7900000,-4100000,1960
1961-01-01,4189,The Misfits,4000000,8200000,8200000,4200000,1960
1961-01-01,4359,Judgment at Nuremberg,3000000,10000000,10000000,7000000,1960
1961-01-01,4436,Pocketful of Miracles,2900000,5000000,5000000,2100000,1960
1961-09-25,4558,The Hustler,2000000,7600000,7600000,5600000,1960
1961-10-18,3834,West Side Story,6000000,43700000,43700000,37700000,1960
1962-01-01,4322,The Man Who Shot Liberty Valance,3200000,8000000,8000000,4800000,1960
1962-01-01,4555,Lolita,2000000,9250000,9250000,7250000,1960
1962-04-10,3320,The Longest Day,10000000,50100000,39100000,40100000,1960
1962-08-11,2546,Mutiny on The Bounty,19000000,13680000,13680000,-5320000,1960
1962-09-03,4122,State Fair,4500000,3500000,3500000,-1000000,1960
1962-12-16,2827,Lawrence of Arabia,15000000,69995385,37495385,54995385,1960
1962-12-25,4550,To Kill A Mockingbird,2000000,13129846,13129846,11129846,1960
1963-01-01,2698,55 Days at Peking,17000000,10000000,10000000,-7000000,1960
1963-01-01,4454,Donovan's Reef,2686000,6600000,6600000,3914000,1960
1963-05-29,4478,Hud,2500000,10000000,10000000,7500000,1960
1963-07-10,4842,Tom Jones,1000000,37600000,37600000,36600000,1960
1963-07-11,3501,It's a Mad Mad Mad Mad World,9400000,60000000,46300000,50600000,1960
1963-08-05,4849,Dr. No,1000000,59567035,16067035,58567035,1960
1963-08-08,4181,The Great Escape,4000000,11744471,11744471,7744471,1960
1963-12-06,1253,Cleopatra,42000000,71000000,57000000,29000000,1960
1964-01-01,2552,The Fall of the Roman Empire,19000000,4750000,4750000,-14250000,1960
1964-01-29,4664,Dr. Strangelove,1800000,9164370,9164370,7364370,1960
1964-08-04,4543,From Russia With Love,2000000,78900000,24800000,76900000,1960
1964-08-26,3832,Mary Poppins,6000000,102300000,102300000,96300000,1960
1964-10-22,2670,My Fair Lady,17000000,72070955,72000000,55070955,1960
1964-11-08,5040,A Hard Day's Night,560000,1597233,1537860,1037233,1960
1964-12-22,4334,Goldfinger,3000000,124900000,51100000,121900000,1960
1965-02-03,3594,The Sound of Music,8200000,286214286,163214286,278014286,1960
1965-02-15,2425,The Greatest Story Ever Told,20000000,15473333,15473333,-4526667,1960
1965-07-03,3907,The Train,5800000,6800000,6800000,1000000,1960
1965-07-04,4254,Major Dundee,3800000,14873,14873,-3785127,1960
1965-12-22,3241,Doctor Zhivago,11000000,111859493,111721000,100859493,1960
1965-12-29,3514,Thunderball,9000000,141200000,63600000,132200000,1960
1966-02-23,4276,Harper,3500000,12000000,12000000,8500000,1960
1966-07-16,4354,Torn Curtain,3000000,13000000,13000000,10000000,1960
1966-10-10,2831,Hawaii,15000000,34562222,34562222,19562222,1960
1966-12-12,4249,A Man for All Seasons,3900000,28350000,28350000,24450000,1960
1967-01-01,4273,In Cold Blood,3500000,13007551,13000000,9507551,1960
1967-01-18,5232,Per un pugno di dollari,200000,3500000,3500000,3300000,1960
1967-02-08,4546,In the Heat of the Night,2000000,24391108,24379978,22391108,1960
1967-04-28,3159,Casino Royale,12000000,41744718,22744718,29744718,1960
1967-06-13,3496,You Only Live Twice,9500000,111600000,43100000,102100000,1960
1967-10-05,5029,Per qualche dollaro in più,600000,4300000,4300000,3700000,1960
1967-12-29,4799,"Il buono, il brutto, il cattivo",1200000,6100000,6100000,4900000,1960
1968-01-01,4757,Shalako,1455000,2620000,2620000,1165000,1960
1968-01-10,5292,Night of the Living Dead,114000,30000000,12000000,29886000,1960
1968-02-04,3295,2001: A Space Odyssey,10500000,68700000,56700000,58200000,1960
1968-03-08,4667,Hang 'em High,1800000,6800000,6800000,5000000,1960
1968-06-25,5008,La mariée était en noir ,747000,44566,44566,-702434,1960
1968-08-02,3906,The Planet of the Apes,5800000,33395426,33395426,27595426,1960
1968-10-10,3559,Barbarella,9000000,0,0,-9000000,1960
1968-11-12,3323,Oliver!,10000000,37402877,37402877,27402877,1960
1968-12-06,4321,Rosemary's Baby,3200000,33395426,33395426,30195426,1960
1969-01-01,2465,Sweet Charity,20000000,8000000,8000000,-12000000,1960
1969-05-25,4263,Midnight Cowboy,3600000,44785053,44785053,41185053,1960
1969-05-28,4032,C'era una volta il West,5000000,5321508,5321508,321508,1960
1969-06-18,3883,The Wild Bunch,6000000,509424,509424,-5490576,1960
1969-07-25,5228,The Stewardesses,200000,25000000,13500000,24800000,1960
1969-10-15,2375,Paint Your Wagon,20000000,31678778,31678778,11678778,1960
1969-10-24,3831,Butch Cassidy and the Sundance Kid,6000000,102308900,102308900,96308900,1960
1969-12-16,2175,"Hello, Dolly",24000000,33208099,33208099,9208099,1960
1969-12-18,3613,On Her Majesty's Secret Service,8000000,82000000,22800000,74000000,1960
1969-12-19,4195,Topaz,4000000,6000000,6000000,2000000,1960
1970-01-01,2159,Waterloo,25000000,0,0,-25000000,1970
1970-01-01,2270,Darling Lili,22000000,5000000,5000000,-17000000,1970
1970-01-01,3136,Patton,12000000,62500000,62500000,50500000,1970
1970-01-01,3277,The Molly Maguires,11000000,2200000,2200000,-8800000,1970
1970-01-01,4265,M*A*S*H,3500000,81600000,81600000,78100000,1970
1970-01-01,4855,Beyond the Valley of the Dolls,1000000,9000000,9000000,8000000,1970
1970-03-26,5027,Woodstock,600000,34505110,34505110,33905110,1970
1970-05-13,4259,The Ballad of Cable Hogue,3716946,5000000,3500000,1283054,1970
1970-05-26,4349,Beneath the Planet of the Apes,3000000,17489009,17489009,14489009,1970
1970-06-24,2598,Catch-22,18000000,24911670,24911670,6911670,1970
1970-09-23,2076,"Tora, Tora, Tora",25000000,29548291,29548291,4548291,1970
1971-01-01,3512,Fiddler on the Roof,9000000,80500000,80500000,71500000,1970
1971-01-01,3809,The Andromeda Strain,6500000,12376563,12376563,5876563,1970
1971-01-01,4477,Escape from the Planet of the Apes,2500000,12300000,12300000,9800000,1970
1971-01-01,5270,Sweet Sweetback's Baad Asssss Song,150000,15200000,15200000,15050000,1970
1971-04-28,4626,Bananas,2000000,0,0,-2000000,1970
1971-06-30,4379,Willy Wonka & the Chocolate Factory,3000000,4000000,4000000,1000000,1970
1971-09-10,4526,The French Connection,2200000,41158757,41158757,38958757,1970
1971-12-17,3705,Diamonds Are Forever,7200000,116000000,43800000,108800000,1970
1972-01-01,4686,Conquest of the Planet of the Apes,1700000,9700000,9700000,8000000,1970
1972-03-15,3709,The Godfather,7000000,268500000,134966411,261500000,1970
1972-06-21,4275,Frenzy,3500000,12600000,12600000,9100000,1970
1972-06-30,5356,Deep Throat,25000,45000000,45000000,44975000,1970
1972-08-30,5314,The Last House on the Left,87000,3100000,3100000,3013000,1970
1972-09-11,4239,1776,4000000,0,0,-4000000,1970
1972-11-08,4548,Everything You Always Wanted to Know,2000000,18016290,18016290,16016290,1970
1973-01-01,4665,Battle for the Planet of the Apes,1800000,8800000,8800000,7000000,1970
1973-05-23,4106,Pat Garrett and Billy the Kid,4638783,11000000,8000000,6361217,1970
1973-06-27,3714,Live and Let Die,7000000,161800000,35400000,154800000,1970
1973-08-22,3926,High Plains Drifter,5500000,15700000,15700000,10200000,1970
1973-11-08,4994,American Graffiti,777000,140000000,115000000,139223000,1970
1973-12-17,4547,Sleeper,2000000,18344729,18344729,16344729,1970
1973-12-25,3921,The Sting,5500000,159616327,159616327,154116327,1970
1973-12-26,3121,The Exorcist,12000000,400214478,202347346,388214478,1970
1974-01-01,4458,Blazing Saddles,2600000,119500000,119500000,116900000,1970
1974-03-29,3720,The Great Gatsby,7000000,26533200,26533200,19533200,1970
1974-07-04,4696,The Conversation,1600000,4420000,4420000,2820000,1970
1974-10-18,5280,The Texas Chainsaw Massacre,140000,26572439,26572439,26432439,1970
1974-11-12,3038,The Godfather: Part II,13000000,57300000,57300000,44300000,1970
1974-11-15,5049,Benji,500000,31559560,31559560,31059560,1970
1974-12-15,4442,Young Frankenstein,2800000,86300000,86300000,83500000,1970
1974-12-17,2961,Towering Inferno,14000000,139700000,116000000,125700000,1970
1974-12-17,4176,The Front Page,4000000,15000000,15000000,11000000,1970
1974-12-20,3726,The Man with the Golden Gun,7000000,97600000,21000000,90600000,1970
1975-01-01,3261,Barry Lyndon,11000000,20169934,20000000,9169934,1970
1975-01-04,5176,Death Race 2000,300000,0,0,-300000,1970
1975-05-16,3968,The Return of the Pink Panther,5000000,41833347,41833347,36833347,1970
1975-06-20,3120,Jaws,12000000,470700000,260000000,458700000,1970
1975-09-26,4791,The Rocky Horror Picture Show,1200000,140556781,140510017,139356781,1970
1975-10-05,5125,Monty Python and the Holy Grail,400000,5028948,3427696,4628948,1970
1975-10-06,4344,Love and Death,3000000,20123742,20123742,17123742,1970
1975-11-19,4145,One Flew Over the Cuckoo's Nest,4400000,108981275,108981275,104581275,1970
1976-01-01,3723,Logan's Run,7000000,25000000,25000000,18000000,1970
1976-01-01,4251,Network,3800000,23689877,23689877,19889877,1970
1976-01-01,4805,The Blue Bird,1200000,887000,887000,-313000,1970
1976-06-25,4146,Silent Movie,4400000,36145695,36145695,31745695,1970
1976-06-25,4443,The Omen,2800000,48570885,48570885,45770885,1970
1976-08-02,4844,Taxi Driver,1000000,28316211,28262574,27316211,1970
1976-09-04,4353,Family Plot,3000000,13200000,13200000,10200000,1970
1976-11-03,4025,Robin and Marian,5000000,8000000,8000000,3000000,1970
1976-11-16,4661,Carrie,1800000,25878153,25878153,24078153,1970
1976-11-21,4840,Rocky,1000000,225000000,117235147,224000000,1970
1976-12-17,2202,King Kong,23000000,90614445,52614445,67614445,1970
1977-01-01,5051,Kingdom of the Spiders,500000,17000000,17000000,16500000,1970
1977-01-01,5297,Eraserhead,100000,7012524,7000000,6912524,1970
1977-03-11,3326,Pete’s Dragon,10000000,36000000,36000000,26000000,1970
1977-04-20,4165,Annie Hall,4000000,38251425,38251425,34251425,1970
1977-05-08,3765,March or Die,7000000,1000000,1000000,-6000000,1970
1977-05-25,3239,Star Wars Ep. IV: A New Hope,11000000,786598007,460998007,775598007,1970
1977-06-15,1978,A Bridge Too Far,26000000,50800000,50800000,24800000,1970
1977-06-17,2980,Exorcist II: The Heretic,14000000,25011000,25011000,11011000,1970
1977-06-22,2989,"New York, New York",14000000,13800000,13800000,-200000,1970
1977-06-24,2278,Sorcerer,21600000,12000000,12000000,-9600000,1970
1977-07-13,2969,The Spy Who Loved Me,14000000,185400000,46800000,171400000,1970
1977-10-08,5028,The Kentucky Fried Movie,600000,20000000,15000000,19400000,1970
1977-10-21,2713,Damnation Alley,17000000,0,0,-17000000,1970
1977-11-16,2309,Close Encounters of the Third Kind,20000000,337700000,166000000,317700000,1970
1977-12-23,4304,High Anxiety,3400000,31063038,31063038,27663038,1970
1978-01-01,3009,Caravans,14000000,1000000,1000000,-13000000,1970
1978-01-01,3165,The Boys from Brazil,12000000,19000000,19000000,7000000,1970
1978-01-01,4338,Coming Home,3000000,32653000,32653000,29653000,1970
1978-04-13,3260,F.I.S.T,11000000,20388920,20388920,9388920,1970
1978-06-16,2318,Jaws 2,20000000,208900376,102922376,188900376,1970
1978-06-16,3828,Grease,6000000,387513770,181813770,381513770,1970
1978-06-28,2798,Heaven Can Wait,15000000,98800000,98800000,83800000,1970
1978-07-28,4330,National Lampoon's Animal House,3000000,141600000,141600000,138600000,1970
1978-09-13,4382,Days of Heaven,3000000,3660880,3446749,660880,1970
1978-10-17,5153,Halloween,325000,70000000,47000000,69675000,1970
1978-10-24,2186,The Wiz,24000000,13000000,13000000,-11000000,1970
1978-12-15,912,Superman,55000000,300200000,134218018,245200000,1970
1978-12-22,4026,Force 10 from Navarone,5000000,7100000,7100000,2100000,1970
1979-01-01,2814,The Deer Hunter,15000000,50000000,50000000,35000000,1970
1979-02-02,3885,The First Great Train Robbery,6000000,391942,391942,-5608058,1970
1979-04-20,4717,Dawn of the Dead,1500000,55000000,5100000,53500000,1970
1979-05-25,3106,The Prisoner of Zenda,12500000,7000000,7000000,-5500000,1970
1979-05-25,3510,Alien,9000000,203630630,80930630,194630630,1970
1979-06-15,3160,Prophecy,12000000,22673340,22673340,10673340,1970
1979-06-22,3598,The Muppet Movie,8000000,76657000,76657000,68657000,1970
1979-06-22,3604,Escape from Alcatraz,8000000,43000000,43000000,35000000,1970
1979-06-29,1696,Moonraker,31000000,210300000,70300000,179300000,1970
1979-06-30,5266,Dolphin,170000,14000,14000,-156000,1970
1979-07-11,3573,The Rose,8500000,29200000,29200000,20700000,1970
1979-07-12,1521,Star Trek: The Motion Picture,35000000,139000000,82258456,104000000,1970
1979-08-15,1691,Apocalypse Now,31500000,81250488,78800000,49750488,1970
1979-08-17,4173,The Life of Brian,4000000,20008693,20008693,16008693,1970
1979-10-17,4449,The Black Stallion,2700000,37799643,37799643,35099643,1970
1979-10-19,2759,Meteor,16000000,8400000,8400000,-7600000,1970
1979-12-14,1676,1941,32000000,94875000,34175000,62875000,1970
1979-12-21,2361,The Black Hole,20000000,35841901,35841901,15841901,1970
1980-01-01,1624,Lion of the Desert,35000000,1500000,1500000,-33500000,1980
1980-01-01,3805,Dressed to Kill,6500000,31899000,31899000,25399000,1980
1980-01-01,4279,Terror Train,3500000,8000000,8000000,4500000,1980
1980-01-01,5144,Maniac,350000,10000000,10000000,9650000,1980
1980-01-02,4846,The Fog,1000000,21378361,21378361,20378361,1980
1980-01-08,1414,Raise the Titanic,40000000,7000000,7000000,-33000000,1980
1980-03-10,3952,Somewhere in Time,5100000,9709597,9709597,4609597,1980
1980-03-10,3977,The Elephant Man,5000000,26010864,26010864,21010864,1980
1980-03-21,5229,Mad Max,200000,99750000,8750000,99550000,1980
1980-04-07,4264,Airplane!,3500000,83453539,83453539,79953539,1980
1980-05-12,1573,Flash Gordon,35000000,27107960,27107960,-7892040,1980
1980-05-16,3374,The Long Riders,10000000,15198912,15198912,5198912,1980
1980-05-16,5132,Home Movies,400000,89134,89134,-310866,1980
1980-05-21,2196,Star Wars Ep. V: The Empire Strikes Back,23000000,534171960,290271960,511171960,1980
1980-05-23,2536,The Shining,19000000,44391156,44017374,25391156,1980
1980-06-06,3929,Galaxina,5500000,4865000,4865000,-635000,1980
1980-06-13,2261,The Island,22000000,15716828,15716828,-6283172,1980
1980-06-20,1941,The Blues Brothers,27000000,57229890,57229890,30229890,1980
1980-06-20,2490,Can't Stop the Music,20000000,2000000,2000000,-18000000,1980
1980-06-20,4115,The Blue Lagoon,4500000,47923795,47923795,43423795,1980
1980-07-03,2805,Coal Miner's Daughter,15000000,67182787,67182787,52182787,1980
1980-07-25,3836,Caddyshack,6000000,39846344,39846344,33846344,1980
1980-09-05,5044,Friday the 13th,550000,59754601,39754601,59204601,1980
1980-09-19,3833,Ordinary People,6000000,52302978,52302978,46302978,1980
1980-10-05,5301,Penitentiary,100000,287000,287000,187000,1980
1980-10-10,2804,Private Benjamin,15000000,69847348,69847348,54847348,1980
1980-11-14,2600,Raging Bull,18000000,23380203,23380203,5380203,1980
1980-11-19,1238,Heaven's Gate,44000000,3484523,3484331,-40515477,1980
1980-12-12,2340,Popeye,20000000,49823037,49823037,29823037,1980
1981-01-01,2707,Roar,17000000,2110050,2110050,-14889950,1980
1981-01-05,5185,Graduation Day,250000,23894000,23894000,23644000,1980
1981-03-20,3177,The Postman Always Rings Twice,12000000,44200000,12200000,32200000,1980
1981-04-12,1642,Reds,33500000,50000000,50000000,16500000,1980
1981-04-30,4784,Friday the 13th Part 2,1250000,21722776,21722776,20472776,1980
1981-05-22,2617,The Legend of the Lone Ranger,18000000,13400000,13400000,-4600000,1980
1981-05-22,3804,The Four Seasons,6500000,42488161,42488161,35988161,1980
1981-06-11,3143,Time Bandits,12000000,37400000,37400000,25400000,1980
1981-06-19,969,Superman II,54000000,108185706,108185706,54185706,1980
1981-06-26,1896,For Your Eyes Only,28000000,195300000,54800000,167300000,1980
1981-06-26,2625,Dragonslayer,18000000,6000000,6000000,-12000000,1980
1981-06-26,3306,Stripes,10000000,85300000,85300000,75300000,1980
1981-07-08,3504,Heavy Metal,9300000,19571091,19571091,10271091,1980
1981-07-24,2615,Blow Out,18000000,13747234,13747234,-4252766,1980
1981-07-31,2409,Under the Rainbow,20000000,18826490,18826490,-1173510,1980
1981-08-28,4370,Gallipoli,3000000,5732587,5732587,2732587,1980
1981-09-12,2971,Taps,14000000,35856053,35856053,21856053,1980
1981-09-18,3992,Mommie Dearest,5000000,25032000,19032000,20032000,1980
1981-09-25,3922,Chariots of Fire,5500000,57467731,57159946,51967731,1980
1981-10-04,4001,Nighthawks,5000000,19600000,14600000,14600000,1980
1981-10-04,4848,The Howling,1000000,17985000,17985000,16985000,1980
1981-10-07,3840,Escape from New York,6000000,25244700,25244700,19244700,1980
1981-10-30,4474,Halloween II,2500000,25533818,25533818,23033818,1980
1981-11-02,3427,Sphinx,10000000,11400000,2000000,1400000,1980
1981-11-13,3201,The Pursuit of D.B. Cooper,12000000,2104164,2104164,-9895836,1980
1981-12-06,2306,Raiders of the Lost Ark,20000000,389925971,248159971,369925971,1980
1981-12-06,2843,Clash of the Titans,15000000,44400000,30000000,29400000,1980
1981-12-06,3256,History of the World: Part I,11000000,31672000,31672000,20672000,1980
1981-12-18,3409,Heartbeeps,10000000,6000000,6000000,-4000000,1980
1981-12-25,3612,Modern Problems,8000000,24474312,24474312,16474312,1980
1982-01-29,3024,The Border,13500000,6118683,6118683,-7381317,1980
1982-02-04,3105,Cat People,12500000,21000000,7000000,8500000,1980
1982-02-04,4011,Diner,5000000,12592907,12592907,7592907,1980
1982-03-11,3988,The Man From Snowy River,5000000,20659423,20659423,15659423,1980
1982-03-19,4161,Porky's,4000000,109492484,109492484,105492484,1980
1982-04-06,3127,Star Trek II: The Wrath of Khan,12000000,95800000,78912963,83800000,1980
1982-04-06,3290,Poltergeist,10700000,121706019,74706019,111006019,1980
1982-05-14,2355,Conan the Barbarian,20000000,79114085,38264085,59114085,1980
1982-05-21,4544,Mad Max 2: The Road Warrior,2000000,24600832,24600832,22600832,1980
1982-06-18,2286,Firefox,21000000,45785720,45785720,24785720,1980
1982-06-25,1908,Blade Runner,28000000,33139618,32656328,5139618,1980
1982-06-25,2629,Megaforce,18000000,5675599,5675599,-12324401,1980
1982-07-23,2304,The Best Little Whorehouse in Texas,20500000,69701637,69701637,49201637,1980
1982-08-12,2240,Gandhi,22000000,127767889,52767889,105767889,1980
1982-08-12,2728,The Verdict,16000000,53977250,53977250,37977250,1980
1982-08-13,4116,Fast Times at Ridgemont High,4500000,27092880,27092880,22592880,1980
1982-08-13,4525,Friday the 13th Part 3,2250000,36690067,36690067,34440067,1980
1982-08-20,4017,The Beastmaster,5000000,10751126,10751126,5751126,1980
1982-08-20,4318,Class of 1984,3250000,6965361,6965361,3715361,1980
1982-08-27,4041,Jekyll and Hyde... Together Again,5000000,3707583,3707583,-1292417,1980
1982-09-07,2688,Tron,17000000,26918576,26918576,9918576,1980
1982-09-17,1158,Inchon,46000000,4408636,4408636,-41591364,1980
1982-10-02,3179,Das Boot,12000000,84970337,11487676,72970337,1980
1982-10-11,3616,Creepshow,8000000,20036244,20036244,12036244,1980
1982-10-22,2968,First Blood,14000000,125212904,47212904,111212904,1980
1982-10-22,4475,Halloween 3: Season of the Witch,2500000,14400000,14400000,11900000,1980
1982-11-06,3294,ET: The Extra-Terrestrial,10500000,792965326,435110554,782465326,1980
1982-11-19,4808,Q,1200000,255000,255000,-945000,1980
1982-12-02,3099,La Guerre du feu,12500000,20959585,20959585,8459585,1980
1982-12-17,2790,Tootsie,15000000,177200000,177200000,162200000,1980
1983-01-01,5131,E tu vivrai nel terrore - L'aldilà,400000,126387,126387,-273613,1980
1983-02-18,3300,Lovesick,10100000,10143618,10143618,43618,1980
1983-03-06,3129,WarGames,12000000,74433837,74433837,62433837,1980
1983-03-25,3350,The Outsiders,10000000,25697647,25697647,15697647,1980
1983-04-02,3903,Videodrome,5952000,2120439,2120439,-3831561,1980
1983-04-15,3711,Flashdance,7000000,201463574,90463574,194463574,1980
1983-04-15,4012,Lone Wolf McQuade,5000000,12232628,12232628,7232628,1980
1983-04-15,5142,The Evil Dead,375000,29400000,2400000,29025000,1980
1983-05-25,1657,Star Wars Ep. VI: Return of the Jedi,32500000,572705079,309205079,540205079,1980
1983-06-17,1437,Superman III,39000000,59950623,59950623,20950623,1980
1983-06-24,3342,Twilight Zone: The Movie,10000000,29500000,29500000,19500000,1980
1983-07-10,1493,Never Say Never Again,36000000,160000000,55500000,124000000,1980
1983-07-29,2808,National Lampoon’s Vacation,15000000,61400000,61400000,46400000,1980
1983-08-04,3763,Losin' It,7000000,1246141,1246141,-5753859,1980
1983-08-19,4767,The Ballad of Gregorio Cortez,1305000,909000,909000,-396000,1980
1983-09-12,2048,Scarface,25000000,44942821,44942821,19942821,1980
1983-09-30,2896,Brainstorm,15000000,8921050,8921050,-6078950,1980
1983-10-06,1929,Octopussy,27500000,187500000,67900000,160000000,1980
1983-10-21,1949,The Right Stuff,27000000,21500000,21500000,-5500000,1980
1983-10-21,3357,The Dead Zone,10000000,20766000,20766000,10766000,1980
1983-10-28,3648,The Wicked Lady,8000000,589308,589308,-7410692,1980
1983-11-18,3140,Yentl,12000000,39012241,39012241,27012241,1980
1983-11-18,4317,A Christmas Story,3250000,20605209,20605209,17355209,1980
1984-01-06,1841,Once Upon a Time in America,30000000,5564014,5321508,-24435986,1980
1984-01-06,2570,Star Trek III: The Search for Spock,18000000,87000000,76471046,69000000,1980
1984-02-03,4722,Repo Man,1500000,2300000,2300000,800000,1980
1984-02-17,3595,Footloose,8200000,80000000,80000000,71800000,1980
1984-03-16,3529,The Ice Pirates,9000000,13075390,13075390,4075390,1980
1984-03-23,4113,Police Academy,4500000,81198894,81198894,76698894,1980
1984-04-13,4459,Friday the 13th Part IV: The Final Chapter,2600000,32980880,32980880,30380880,1980
1984-04-27,5045,Love Letters,550000,5269990,5269990,4719990,1980
1984-05-12,2788,Beverly Hills Cop,15000000,316300000,234760478,301300000,1980
1984-05-23,1882,Indiana Jones and the Temple of Doom,28000000,333080271,179880271,305080271,1980
1984-06-22,3597,The Karate Kid,8000000,90815558,90815558,82815558,1980
1984-06-29,2596,Conan the Destroyer,18000000,26400000,26400000,8400000,1980
1984-07-20,1950,Die Unendliche Geschichte,27000000,21300000,21300000,-5700000,1980
1984-08-06,1704,Ghostbusters,30000000,295212467,242212467,265212467,1980
1984-08-06,3240,Gremlins,11000000,148168459,148168459,137168459,1980
1984-08-17,2133,Sheena,25000000,5778353,5778353,-19221647,1980
1984-08-31,4786,C.H.U.D.,1250000,4700000,4700000,3450000,1980
1984-09-03,3599,Splash,8000000,62599495,62599495,54599495,1980
1984-09-03,3686,The Hotel New Hampshire,7500000,5142858,5142858,-2357142,1980
1984-09-11,4662,A Nightmare on Elm Street,1800000,25504513,25504513,23704513,1980
1984-09-19,2581,Amadeus,18000000,51973029,51973029,33973029,1980
1984-10-26,3392,Body Double,10000000,8801940,8801940,-1198060,1980
1984-10-26,3820,The Terminator,6400000,78019031,38019031,71619031,1980
1984-11-05,2871,Firestarter,15000000,15136870,15136870,136870,1980
1984-12-14,1139,The Cotton Club,48000000,25928721,25928721,-22071279,1980
1984-12-14,1204,Dune,45000000,27447471,27447471,-17552529,1980
1984-12-14,1933,A Passage to India,27500000,27187653,27187653,-312347,1980
1984-12-31,5109,The Toxic Avenger,475000,0,0,-475000,1980
1985-01-11,4342,A Nightmare On Elm Street Part 2: Freddy's Revenge,3000000,21163999,21163999,18163999,1980
1985-01-18,4724,Blood Simple,1500000,2730877,1690913,1230877,1980
1985-03-07,2527,Back to the Future,19000000,385524862,212259762,366524862,1980
1985-03-15,4775,Def-Con 4,1300000,210904,210904,-1089096,1980
1985-03-22,3333,The Last Dragon,10000000,33000000,33000000,23000000,1980
1985-03-22,4527,Friday the 13th Part V: A New Beginning,2200000,21930418,21930418,19730418,1980
1985-04-10,3328,Commando,10000000,35073978,35073978,25073978,1980
1985-04-12,2604,Young Sherlock Holmes,18000000,19739000,19739000,1739000,1980
1985-05-22,1233,Rambo: First Blood Part II,44000000,300400000,150415432,256400000,1980
1985-05-24,1762,A View to a Kill,30000000,152627960,50327960,122627960,1980
1985-06-11,4592,Subway,2000000,1663296,390659,-336704,1980
1985-06-21,1955,Return to Oz,27000000,10618813,10618813,-16381187,1980
1985-06-21,2117,Lifeforce,25000000,11603545,11603545,-13396455,1980
1985-06-28,2654,Red Sonja,17900000,6905861,6905861,-10994139,1980
1985-06-28,3788,Pale Rider,6900000,41410568,41410568,34510568,1980
1985-06-30,4283,Day of the Dead,3500000,34004262,5804262,30504262,1980
1985-08-02,3132,Witness,12000000,65532576,65532576,53532576,1980
1985-08-16,4178,The Return of the Living Dead,4000000,14237880,14237880,10237880,1980
1985-09-27,3365,Invasion U.S.A.,10000000,17536256,17536256,7536256,1980
1985-10-07,1986,Silverado,26000000,33200000,33200000,7200000,1980
1985-10-07,3325,Mad Max Beyond Thunderdome,10000000,36230219,36230219,26230219,1980
1985-10-25,4356,Krush Groove,3000000,11052713,11052713,8052713,1980
1985-11-10,3737,Silver Bullet,7000000,10803211,10803211,3803211,1980
1985-12-04,2410,Ladyhawke,20000000,18400000,18400000,-1600000,1980
1985-12-18,1695,Out of Africa,31000000,258210860,79096868,227210860,1980
1985-12-18,2799,The Color Purple,15000000,93589701,93589701,78589701,1980
1985-12-18,2890,Brazil,15000000,9930649,9929135,-5069351,1980
1986-01-04,5136,My Beautiful Laundrette,400000,0,0,-400000,1980
1986-01-07,1424,Pirates,40000000,6341825,1641825,-33658175,1980
1986-01-07,2121,Big Trouble in Little China,25000000,11100000,11100000,-13900000,1980
1986-01-08,1822,Howard the Duck,30000000,16295774,16295774,-13704226,1980
1986-01-08,4345,Friday the 13th Part VI: Jason Lives,3000000,19472057,19472057,16472057,1980
1986-01-17,2921,The Clan of the Cave Bear,15000000,1953732,1953732,-13046268,1980
1986-02-21,2623,Nine 1/2 Weeks,18000000,6734844,6734844,-11265156,1980
1986-03-10,1623,Playing for Keeps,35000000,2000000,2000000,-33000000,1980
1986-03-27,4010,April Fool's Day,5000000,12947763,12947763,7947763,1980
1986-04-18,2102,Legend,25000000,23506237,15502112,-1493763,1980
1986-04-23,4125,Salvador,4500000,1500000,1500000,-3000000,1980
1986-04-25,2641,8 Million Ways to Die,18000000,1305114,1305114,-16694886,1980
1986-05-16,2789,Top Gun,15000000,356800601,179800601,341800601,1980
1986-06-06,3193,Invaders from Mars,12000000,4984663,4884663,-7015337,1980
1986-06-18,1340,Legal Eagles,40000000,49851591,49851591,9851591,1980
1986-07-03,2760,Highlander,16000000,12900000,5900000,-3100000,1980
1986-07-03,4343,A Room with a View,3000000,20966644,20966644,17966644,1980
1986-07-18,2667,Aliens,17000000,183316455,85160248,166316455,1980
1986-08-08,3602,Stand by Me,8000000,52287414,52287414,44287414,1980
1986-08-08,5261,She's Gotta Have It,175000,7137502,7137502,6962502,1980
1986-08-22,4101,The Texas Chainsaw Massacre 2,4700000,8025872,8025872,3325872,1980
1986-08-29,2705,Shanghai Surprise,17000000,2315000,2315000,-14685000,1980
1986-09-26,3564,Crocodile Dundee,8800000,328203506,174803506,319403506,1980
1986-10-10,2586,Peggy Sue Got Married,18000000,41382841,41382841,23382841,1980
1986-10-17,3314,The Color of Money,10000000,52293000,52293000,42293000,1980
1986-11-26,2164,Star Trek IV: The Voyage Home,24000000,133000000,109713132,109000000,1980
1986-12-12,3126,The Golden Child,12000000,79817937,79817937,67817937,1980
1986-12-19,1779,Little Shop of Horrors,30000000,38747385,38747385,8747385,1980
1986-12-19,3829,Platoon,6000000,137963328,137963328,131963328,1980
1986-12-31,4559,Witchboard,2000000,7369373,7369373,5369373,1980
1987-01-01,4461,Maurice,2600000,3147950,3147950,547950,1980
1987-01-01,5145,American Ninja 2: The Confrontation,350000,4000000,4000000,3650000,1980
1987-01-03,5298,Hollywood Shuffle,100000,5228617,5228617,5128617,1980
1987-01-05,3423,Malone,10000000,3000000,3000000,-7000000,1980
1987-01-05,4272,Creepshow 2,3500000,14000000,14000000,10500000,1980
1987-01-30,2751,Radio Days,16000000,14792779,14792779,-1207221,1980
1987-02-27,3965,A Nightmare On Elm Street 3: Dream Warriors,5000000,44793222,44793222,39793222,1980
1987-03-06,2026,The Untouchables,25000000,76270454,76270454,51270454,1980
1987-03-13,4282,Evil Dead II,3500000,5923044,5923044,2423044,1980
1987-03-31,4209,The Barbarians,4000000,800000,800000,-3200000,1980
1987-04-09,4827,The Offspring,1100000,1355728,1355728,255728,1980
1987-05-15,1400,Ishtar,40000000,14375181,14375181,-25624819,1980
1987-05-20,2310,Beverly Hills Cop II,20000000,276665036,153665036,256665036,1980
1987-06-03,2806,Lethal Weapon,15000000,120192350,65192350,105192350,1980
1987-06-11,1877,Cry Freedom,29000000,25899797,5899797,-3100203,1980
1987-06-19,4523,The Brave Little Toaster,2300000,0,0,-2300000,1980
1987-06-24,2227,Spaceballs,22700000,38119483,38119483,15419483,1980
1987-07-17,2213,Jaws 4: The Revenge,23000000,15728335,15728335,-7271665,1980
1987-07-17,3040,RoboCop,13000000,53424681,53424681,40424681,1980
1987-07-24,2697,Superman IV: The Quest for Peace,17000000,11227824,11227824,-5772176,1980
1987-07-24,3803,La Bamba,6500000,54215416,54215416,47715416,1980
1987-07-31,1337,The Living Daylights,40000000,191200000,51185000,151200000,1980
1987-07-31,3572,The Lost Boys,8500000,32222567,32222567,23722567,1980
1987-08-05,4649,River's Edge,1900000,4600000,4600000,2700000,1980
1987-09-18,2959,Fatal Attraction,14000000,320100000,156645693,306100000,1980
1987-09-18,4850,Hellraiser,1000000,14564000,14564000,13564000,1980
1987-09-25,2839,The Princess Bride,15000000,30857000,30857000,15857000,1980
1987-11-12,2717,Wall Street,16500000,43848100,43848100,27348100,1980
1987-11-13,1783,The Running Man,30000000,38122000,38122000,8122000,1980
1987-11-20,2050,The Last Emperor,25000000,43988888,43984987,18988888,1980
1987-11-20,4364,Teen Wolf Too,3000000,7888000,7888000,4888000,1980
1987-11-25,2791,3 Men and a Baby,15000000,167780960,167780960,152780960,1980
1987-12-06,2576,Predator,18000000,98267558,59735548,80267558,1980
1987-12-23,3031,Good Morning Vietnam,13000000,123922370,123922370,110922370,1980
1988-01-04,2100,"Bright Lights, Big City",25000000,16118077,16118077,-8881923,1980
1988-01-10,3994,Halloween 4: The Return of Michael Myers,5000000,17768757,17768757,12768757,1980
1988-01-12,4200,Talk Radio,4000000,3468572,3468572,-531428,1980
1988-01-15,3825,Return of the Living Dead Part II,6200000,9205924,9205924,3005924,1980
1988-02-26,4711,Bloodsport,1500000,11806119,11806119,10306119,1980
1988-03-06,2567,Big,18000000,151668774,114968774,133668774,1980
1988-03-30,2801,Beetle Juice,15000000,73326666,73326666,58326666,1980
1988-04-03,4215,Prison,4000000,354704,354704,-3645296,1980
1988-04-11,4179,They Live,4000000,13000000,13000000,9000000,1980
1988-04-22,4102,Lady in White,4700000,1705139,1705139,-2994861,1980
1988-05-13,4445,Friday the 13th Part VII: The New Blood,2800000,19170001,19170001,16370001,1980
1988-05-25,884,Rambo III,58000000,188715611,53715611,130715611,1980
1988-05-25,2962,Crocodile Dundee 2,14000000,239606210,109306210,225606210,1980
1988-06-22,638,Who Framed Roger Rabbit?,70000000,351500000,154112492,281500000,1980
1988-07-15,1885,Die Hard,28000000,139109346,81350242,111109346,1980
1988-07-20,1781,Midnight Run,30000000,81613606,38413606,51613606,1980
1988-08-07,4366,Phantasm II,3000000,7282851,7282851,4282851,1980
1988-08-19,3041,A Nightmare on Elm Street 4: The Dream Master,13000000,49369899,49369899,36369899,1980
1988-09-11,3519,Child's Play,9000000,44196684,33244684,35196684,1980
1988-09-12,2755,My Stepmother Is an Alien,16000000,13854000,13854000,-2146000,1980
1988-09-12,2795,Twins,15000000,216600000,111936388,201600000,1980
1988-10-06,3497,Poltergeist III,9500000,14114000,14114000,4614000,1980
1988-10-21,3851,Mystic Pizza,6000000,12793213,12793213,6793213,1980
1988-11-18,3119,The Land Before Time,12300000,81972846,48092846,69672846,1980
1988-11-23,1667,Scrooged,32000000,59450353,59450353,27450353,1980
1988-12-02,3727,Action Jackson,7000000,20257000,20257000,13257000,1980
1988-12-02,3849,School Daze,6000000,14545844,14545844,8545844,1980
1988-12-08,3045,Young Guns,13000000,44726644,44726644,31726644,1980
1988-12-08,3743,The Last Temptation of Christ,7000000,8373585,8373585,1373585,1980
1988-12-16,2008,Rain Man,25000000,412800000,172825435,387800000,1980
1988-12-21,2974,Dangerous Liaisons,14000000,34700000,34700000,20700000,1980
1989-01-03,2886,New York Stories,15000000,10763469,10763469,-4236531,1980
1989-02-06,2724,Dead Poets Society,16400000,239500000,95860116,223100000,1980
1989-02-17,3319,Bill & Ted's Excellent Adventure,10000000,40485039,40485039,30485039,1980
1989-03-22,2622,Troop Beverly Hills,18000000,7190505,7190505,-10809495,1980
1989-04-08,4793,"Sex, Lies, and Videotape",1200000,36741667,24741667,35541667,1980
1989-04-21,3235,Pet Sematary,11500000,57469179,57469179,45969179,1980
1989-05-19,3340,Road House,10000000,30050028,30050028,20050028,1980
1989-05-24,1124,Indiana Jones and the Last Crusade,48000000,474171806,197171806,426171806,1980
1989-06-23,1510,Batman,35000000,411348924,251188924,376348924,1980
1989-06-30,3839,Do the Right Thing,6000000,26004026,26004026,20004026,1980
1989-07-04,3248,Major League,11000000,49793054,49793054,38793054,1980
1989-07-14,1260,Licence to Kill,42000000,156167015,34667015,114167015,1980
1989-07-14,2726,When Harry Met Sally…,16000000,92961960,92823546,76961960,1980
1989-07-21,4028,UHF,5000000,6157157,6157157,1157157,1980
1989-07-28,4002,Friday the 13th Part VIII: Jason Takes Manhattan,5000000,14343976,14343976,9343976,1980
1989-08-09,4710,Kickboxer,1500000,14533681,14533681,13033681,1980
1989-08-11,3532,Henry V,9000000,10176701,10161099,1176701,1980
1989-09-06,1758,Star Trek V: The Final Frontier,30000000,70200000,52210049,40200000,1980
1989-09-08,662,The Abyss,70000000,54243125,54243125,-15756875,1980
1989-09-15,2532,Sea of Love,19000000,58571513,58571513,39571513,1980
1989-09-22,1765,Black Rain,30000000,45892212,45892212,15892212,1980
1989-10-13,3856,Halloween 5: The Revenge of Michael Myers,6000000,11642254,11642254,5642254,1980
1989-11-08,3843,A Nightmare On Elm Street: The Dream Child,6000000,22168359,22168359,16168359,1980
1989-11-17,1744,Harlem Nights,30000000,95857262,60857262,65857262,1980
1989-11-22,1285,Back to the Future Part II,40000000,332000000,118450002,292000000,1980
1989-12-13,2595,Glory,18000000,26593580,26593580,8593580,1980
1989-12-13,3677,Driving Miss Daisy,7500000,106593296,106593296,99093296,1980
1989-12-15,2451,We're No Angels,20000000,10555348,10555348,-9444652,1980
1989-12-20,2963,Born on the Fourth of July,14000000,70001698,70001698,56001698,1980
1989-12-20,5281,Roger & Me,140000,6706368,6706368,6566368,1980
1989-12-22,933,Tango & Cash,55000000,63408614,63408614,8408614,1980
1989-12-31,4699,Out of the Dark,1600000,419428,419428,-1180572,1980
1990-01-06,714,Total Recall,65000000,261400000,119394839,196400000,1990
1990-01-19,3368,Tremors,10000000,16667084,16667084,6667084,1990
1990-02-03,1711,The Hunt for Red October,30000000,200500000,120709866,170500000,1990
1990-02-23,3675,The Blood of Heroes,7700000,882290,882290,-6817710,1990
1990-03-07,644,Die Hard 2,70000000,239814025,117323878,169814025,1990
1990-03-08,3370,Mo' Better Blues,10000000,16153000,16153000,6153000,1990
1990-03-08,5121,Metropolitan,430000,2938000,2938000,2508000,1990
1990-03-23,2958,Pretty Woman,14000000,432645872,178406268,418645872,1990
1990-03-30,3019,Teenage Mutant Ninja Turtles,13500000,202000000,135265915,188500000,1990
1990-04-27,4352,Spaced Invaders,3000000,15000000,15000000,12000000,1990
1990-05-24,1300,Back to the Future Part III,40000000,244088654,88055283,204088654,1990
1990-06-15,1061,Gremlins 2: The New Batch,50000000,41476097,41476097,-8523903,1990
1990-06-15,1142,Dick Tracy,47000000,162738726,103738726,115738726,1990
1990-06-27,796,Days of Thunder,60000000,157670733,82670733,97670733,1990
1990-07-12,2338,Edward Scissorhands,20000000,53976987,53976987,33976987,1990
1990-07-13,2231,Ghost,22000000,517600000,217631306,495600000,1990
1990-07-18,1699,Arachnophobia,31000000,53208180,53208180,22208180,1990
1990-09-11,2528,Dances with Wolves,19000000,424200000,184208842,405200000,1990
1990-09-11,3053,Child's Play 2,13000000,34166572,26904572,21166572,1990
1990-09-19,2046,Goodfellas,25000000,46777347,46743809,21777347,1990
1990-09-28,3752,Dark Angel,7000000,4372561,4372561,-2627439,1990
1990-10-08,1974,Flatliners,26000000,61308153,61308153,35308153,1990
1990-10-19,2399,Quigley Down Under,20000000,21413105,21413105,1413105,1990
1990-10-19,4154,Night of the Living Dead,4200000,5835247,5835247,1635247,1990
1990-11-07,1122,The Adventures of Ford Fairlane,49000000,20423389,20423389,-28576611,1990
1990-11-16,2787,Home Alone,15000000,476684675,285761243,461684675,1990
1990-11-21,1571,Predator 2,35000000,54768418,28317513,19768418,1990
1990-12-21,1970,Kindergarten Cop,26000000,202000000,91457688,176000000,1990
1990-12-25,973,The Godfather: Part III,54000000,66520529,66520529,12520529,1990
1990-12-31,5101,Going Under,500000,0,0,-500000,1990
1991-01-01,3278,Return to the Blue Lagoon,11000000,2000000,2000000,-9000000,1990
1991-01-01,3642,Showdown in Little Tokyo,8000000,2275557,2275557,-5724443,1990
1991-01-01,5074,Johnny Suede,500000,55000,55000,-445000,1990
1991-01-01,5111,Straight out of Brooklyn,450000,2712293,2712293,2262293,1990
1991-01-03,1362,The Doors,40000000,34416893,34416893,-5583107,1990
1991-01-03,3576,Haakon Haakonsen,8500000,15024232,15024232,6524232,1990
1991-01-07,5345,The Last Waltz,35000,321952,321952,286952,1990
1991-01-08,5363,Slacker,23000,1227508,1227508,1204508,1990
1991-01-18,1599,Flight of the Intruder,35000000,14471440,14471440,-20528560,1990
1991-01-18,2973,White Fang,14000000,34729091,34729091,20729091,1990
1991-02-07,327,Terminator 2: Judgment Day,100000000,513815401,201858746,413815401,1990
1991-02-14,2314,The Silence of the Lambs,20000000,275726716,130726716,255726716,1990
1991-03-22,2024,Teenage Mutant Ninja Turtles II: The Secret of the Ooze,25000000,78656813,78656813,53656813,1990
1991-05-17,2130,Stone Cold,25000000,9286314,9286314,-15713686,1990
1991-05-24,749,Hudson Hawk,65000000,17218916,17218916,-47781084,1990
1991-06-12,1938,Star Trek VI: The Undiscovered Country,27000000,96900000,74888996,69900000,1990
1991-06-14,1005,Robin Hood: Prince of Thieves,50000000,390500000,165493908,340500000,1990
1991-06-28,2198,The Naked Gun 2½: The Smell of Fear,23000000,86930411,86930411,63930411,1990
1991-07-19,2357,Bill & Ted's Bogus Journey,20000000,37537675,37537675,17537675,1990
1991-08-03,3750,Nikita,7000000,5017971,5017971,-1982029,1990
1991-08-23,2219,Harley Davidson and the Marlboro Man,23000000,7018525,7018525,-15981475,1990
1991-08-30,3882,Beastmaster 2: Through the Portal of Time,6000000,773490,773490,-5226510,1990
1991-09-08,2739,Double Impact,16000000,29090445,29090445,13090445,1990
1991-09-13,3970,Freddy's Dead: The Final Nightmare,5000000,34872033,34872033,29872033,1990
1991-09-20,2173,The Fisher King,24000000,41798224,41798224,17798224,1990
1991-09-29,4480,My Own Private Idaho,2500000,6401336,6401336,3901336,1990
1991-10-01,3742,Warlock,7000000,8824553,8824553,1824553,1990
1991-10-23,3989,House Party 2,5000000,19438638,19438638,14438638,1990
1991-10-25,3548,Due occhi diabolici,9000000,349618,349618,-8650382,1990
1991-11-12,643,Hook,70000000,300854823,119654823,230854823,1990
1991-11-13,2307,Beauty and the Beast,20000000,451329842,218951625,431329842,1990
1991-11-15,1524,Cape Fear,35000000,182291969,79091969,147291969,1990
1991-11-22,1716,The Addams Family,30000000,191502246,113502246,161502246,1990
1991-11-27,2716,My Girl,16500000,58011485,58011485,41511485,1990
1991-12-07,2172,Point Break,24000000,83531958,43218387,59531958,1990
1991-12-07,3802,Boyz n the Hood,6500000,56200634,56190094,49700634,1990
1991-12-20,1315,JFK,40000000,205400000,70405498,165400000,1990
1991-12-25,1732,The Prince of Tides,30000000,74787599,74787599,44787599,1990
1991-12-27,3244,Fried Green Tomatoes,11000000,81204830,81204830,70204830,1990
1992-01-05,3749,Split Second,7000000,5430822,5430822,-1569178,1990
1992-01-07,1251,Boomerang,42000000,131052444,70052444,89052444,1990
1992-01-07,1289,A League of Their Own,40000000,132440066,107533925,92440066,1990
1992-02-10,1265,Hero,42000000,66787173,19487173,24787173,1990
1992-02-10,3316,The Mighty Ducks,10000000,50752337,50752337,40752337,1990
1992-02-14,2315,Wayne's World,20000000,183097323,121697323,163097323,1990
1992-02-21,1620,Radio Flyer,35000000,4651977,4651977,-30348023,1990
1992-02-28,1401,Memoirs of an Invisible Man,40000000,14358033,14358033,-25641967,1990
1992-03-13,3246,My Cousin Vinny,11000000,52929168,52929168,41929168,1990
1992-03-13,3609,Howards End,8000000,26199377,26124872,18199377,1990
1992-04-24,4049,A Midnight Clear,5000000,1526697,1526697,-3473303,1990
1992-05-06,1171,Patriot Games,45000000,178100000,83287363,133100000,1990
1992-05-15,1513,Lethal Weapon 3,35000000,319700000,144731527,284700000,1990
1992-05-22,938,Alien 3,55000000,158500000,54927174,103500000,1990
1992-06-03,3334,The Lawnmower Man,10000000,32100816,32100816,22100816,1990
1992-06-18,491,Batman Returns,80000000,266824291,162833635,186824291,1990
1992-07-02,1346,Medicine Man,40000000,44948240,44948240,4948240,1990
1992-07-08,2956,Unforgiven,14400000,159157447,101157447,144757447,1990
1992-07-08,3259,Raising Cain,11000000,21171695,21171695,10171695,1990
1992-07-31,934,Death Becomes Her,55000000,149022650,58422650,94022650,1990
1992-07-31,3734,Buffy the Vampire Slayer,7000000,14231669,14231669,7231669,1990
1992-09-21,4051,Light Sleeper,5000000,1050861,1050861,-3949139,1990
1992-09-25,1308,The Last of the Mohicans,40000000,75505856,75505856,35505856,1990
1992-09-30,3103,Glengarry Glen Ross,12500000,10725228,10725228,-1774772,1990
1992-10-04,3615,The Player,8000000,28876702,21706101,20876702,1990
1992-10-23,4802,Reservoir Dogs,1200000,2832029,2832029,1632029,1990
1992-11-11,1881,Aladdin,28000000,504050219,217350219,476050219,1990
1992-11-12,1643,A Few Good Men,33000000,236500000,141340178,203500000,1990
1992-11-12,3153,The Muppet Christmas Carol,12000000,27281507,27281507,15281507,1990
1992-11-13,1304,Bram Stoker's Dracula,40000000,215862692,82522790,175862692,1990
1992-11-18,1543,Malcolm X,35000000,48169910,48169910,13169910,1990
1992-11-20,2308,Home Alone 2: Lost in New York,20000000,358994850,173585516,338994850,1990
1992-11-25,2014,The Bodyguard,25000000,410900000,121945720,385900000,1990
1992-11-25,4163,The Crying Game,4000000,62546695,62546695,58546695,1990
1992-12-25,1581,Hoffa,35000000,28391473,23365858,-6608527,1990
1993-01-01,4610,Return of the Living Dead 3,2000000,21000,21000,-1979000,1990
1993-01-01,4673,Ed and his Dead Mother,1800000,673,673,-1799327,1990
1993-01-10,2964,Cool Runnings,14000000,155056263,68856263,141056263,1990
1993-01-10,4983,Ruby in Paradise,800000,1001437,1001437,201437,1990
1993-01-15,1674,Alive,32000000,36299670,36299670,4299670,1990
1993-01-15,2856,Nowhere to Run,15000000,52189039,22189039,37189039,1990
1993-02-04,3806,The Adventures of Huck Finn,6500000,24103594,24103594,17603594,1990
1993-02-19,3268,Army of Darkness,11000000,21502976,11502976,10502976,1990
1993-02-26,5383,El Mariachi,7000,2041928,2040920,2034928,1990
1993-03-09,3188,Fortress,12000000,46730578,6730578,34730578,1990
1993-03-19,2288,Teenage Mutant Ninja Turtles III,21000000,42273609,42273609,21273609,1990
1993-04-16,1621,Bound by Honor,35000000,4496583,4496583,-30503417,1990
1993-04-23,2891,The Dark Half,15000000,9579068,9579068,-5420932,1990
1993-05-02,3050,Loaded Weapon 1,13000000,27979399,27979399,14979399,1990
1993-05-11,2267,RoboCop 3,22000000,10696210,10696210,-11303790,1990
1993-05-11,2855,The Remains of the Day,15000000,63954968,22954968,48954968,1990
1993-05-14,3085,Excessive Force,13000000,1152117,1152117,-11847883,1990
1993-05-26,4267,Menace II Society,3500000,27731527,27731527,24231527,1990
1993-05-28,724,Cliffhanger,65000000,255000000,84049211,190000000,1990
1993-05-28,1264,Super Mario Bros.,42000000,20844907,20844907,-21155093,1990
1993-06-08,1232,The Fugitive,44000000,353715317,183875760,309715317,1990
1993-06-18,462,Last Action Hero,85000000,137298489,50016394,52298489,1990
1993-06-30,1246,The Firm,42000000,270340892,158340892,228340892,1990
1993-07-05,3614,Much Ado About Nothing,8000000,22549338,22549338,14549338,1990
1993-07-16,1904,Hocus Pocus,28000000,39360491,39360491,11360491,1990
1993-07-16,2325,Free Willy,20000000,153698625,77698625,133698625,1990
1993-07-23,2977,Poetic Justice,14000000,27450453,27450453,13450453,1990
1993-08-10,2124,Gettysburg,25000000,10731997,10731997,-14268003,1990
1993-08-13,4351,Jason Goes to Hell: The Final Friday,3000000,15935068,15935068,12935068,1990
1993-08-27,3874,Only the Strong,6000000,3273588,3273588,-2726412,1990
1993-09-06,2824,What's Love Got to Do With It,15000000,39100956,39100956,24100956,1990
1993-09-17,1636,The Age of Innocence,34000000,32014993,32014993,-1985007,1990
1993-09-24,3790,Dazed and Confused,6900000,7950889,7950889,1050889,1990
1993-09-24,4380,Warlock: The Armageddon,3000000,3902679,3902679,902679,1990
1993-10-09,3101,True Romance,12500000,12309980,12281000,-190020,1990
1993-11-06,758,Jurassic Park,63000000,1038812584,395708305,975812584,1990
1993-11-24,2007,Mrs. Doubtfire,25000000,441286003,219195051,416286003,1990
1993-11-24,2553,The Nutcracker,19000000,2119994,2119994,-16880006,1990
1993-12-02,2951,Groundhog Day,14600000,70906973,70906973,56306973,1990
1993-12-02,4401,Braindead,3000000,242623,242623,-2757377,1990
1993-12-11,3712,The Piano,7000000,40157856,40157856,33157856,1990
1993-12-15,2015,Schindler's List,25000000,321365567,96067179,296365567,1990
1993-12-17,1166,The Pelican Brief,45000000,187995859,100768056,142995859,1990
1993-12-22,1972,Philadelphia,26000000,201324422,77324422,175324422,1990
1993-12-25,2034,Tombstone,25000000,56505065,56505065,31505065,1990
1993-12-25,3270,What's Eating Gilbert Grape,11000000,9170214,9170214,-1829786,1990
1993-12-29,2250,Shadowlands,22000000,25842377,25842377,3842377,1990
1994-01-07,1102,Baby's Day Out,50000000,16581575,16581575,-33418425,1990
1994-01-07,1369,The Shadow,40000000,31835600,31835600,-8164400,1990
1994-02-18,1067,On Deadly Ground,50000000,38590458,38590458,-11409542,1990
1994-02-25,3363,Sugar Hill,10000000,18423914,18272447,8423914,1990
1994-03-06,1385,Renaissance Man,40000000,24172899,24172899,-15827101,1990
1994-03-08,762,Clear and Present Danger,62000000,207500000,122012656,145500000,1990
1994-03-18,1760,Naked Gun 33 1/3: The Final Insult,30000000,51041856,51041856,21041856,1990
1994-04-02,3130,Ace Ventura: Pet Detective,12000000,107217396,72217396,95217396,1990
1994-04-02,3419,Romeo Is Bleeding,10000000,3275585,3275585,-6724415,1990
1994-04-11,1209,Frankenstein,45000000,112006296,22006296,67006296,1990
1994-04-13,3071,Serial Mom,13000000,7881335,7881335,-5118665,1990
1994-04-22,3630,The Inkwell,8000000,8864699,8864699,864699,1990
1994-04-29,3538,PCU,9000000,4333569,4333569,-4666431,1990
1994-05-13,2991,Crooklyn,14000000,13024170,13024170,-975830,1990
1994-05-25,1060,Beverly Hills Cop III,50000000,119180938,42586861,69180938,1990
1994-05-27,1162,The Flintstones,45000000,358500000,130531208,313500000,1990
1994-06-05,2446,3 Ninjas Kick Back,20000000,11744960,11744960,-8255040,1990
1994-06-07,906,Forrest Gump,55000000,679850637,330151138,624850637,1990
1994-06-15,557,The Lion King,79300000,987480140,422780140,908180140,1990
1994-06-17,658,Wolf,70000000,131011757,65011757,61011757,1990
1994-06-24,761,Wyatt Earp,63000000,25052000,25052000,-37948000,1990
1994-07-10,1186,The Specialist,45000000,57362581,57362581,12362581,1990
1994-07-15,333,True Lies,100000000,365300000,146282411,265300000,1990
1994-07-20,1169,The Client,45000000,117615211,92115211,72615211,1990
1994-07-29,2566,The Mask,18000000,351620129,119920129,333620129,1990
1994-08-26,3462,Police Academy 7: Mission to Moscow,10000000,126247,126247,-9873753,1990
1994-08-31,4729,Killing Zoe,1500000,418953,418953,-1081047,1990
1994-09-03,4114,Four Weddings and a Funeral,4500000,242895809,52700832,238395809,1990
1994-09-12,924,Disclosure,55000000,212200000,83015089,157200000,1990
1994-09-16,1902,Timecop,28000000,102053581,44853581,74053581,1990
1994-09-23,2079,The Shawshank Redemption,25000000,28307092,28241469,3307092,1990
1994-09-23,4718,Exotica,1500000,5046118,5046118,3546118,1990
1994-09-30,1195,The River Wild,45000000,94215000,46815000,49215000,1990
1994-09-30,2626,Ed Wood,18000000,5828466,5828466,-12171534,1990
1994-10-06,1710,Speed,30000000,283200000,121248145,253200000,1990
1994-10-14,3596,Pulp Fiction,8000000,212928762,107928762,204928762,1990
1994-10-14,3618,Wes Craven's New Nightmare,8000000,18090181,18090181,10090181,1990
1994-10-14,5010,Hoop Dreams,700000,11768371,7768371,11068371,1990
1994-10-19,5353,Clerks,27000,3894240,3073428,3867240,1990
1994-10-21,2437,Bullets Over Broadway,20000000,13383747,13383747,-6616253,1990
1994-10-28,928,Stargate,55000000,196565669,71565669,141565669,1990
1994-11-03,1422,The Hudsucker Proxy,40000000,14938149,2816518,-25061851,1990
1994-11-09,2503,Rapa Nui,20000000,305070,305070,-19694930,1990
1994-11-11,1017,Interview with the Vampire: The Vampire Chronicles,50000000,223564608,105264608,173564608,1990
1994-11-11,2233,The Santa Clause,22000000,189800000,144833357,167800000,1990
1994-11-16,4043,Heavenly Creatures,5000000,5438120,3046086,438120,1990
1994-11-18,1448,Star Trek: Generations,38000000,120000000,75671262,82000000,1990
1994-11-18,2746,Léon,16000000,45284974,19284974,29284974,1990
1994-11-23,3343,A Low Down Dirty Shame,10000000,29317886,29317886,19317886,1990
1994-12-16,2725,Dumb & Dumber,16000000,246400000,127175374,230400000,1990
1994-12-21,1355,Ri¢hie Ri¢h,40000000,38087756,38087756,-1912244,1990
1994-12-21,2813,Little Women,15000000,50003303,50003303,35003303,1990
1994-12-23,1561,Street Fighter,35000000,99423000,33423000,64423000,1990
1994-12-23,1734,Legends of the Fall,30000000,160502573,66502573,130502573,1990
1994-12-25,1942,The Jungle Book,27000000,44342956,44342956,17342956,1990
1994-12-31,3297,There Goes My Baby,10500000,125169,125169,-10374831,1990
1995-01-03,2138,Tank Girl,25000000,4064333,4064333,-20935667,1990
1995-01-07,3017,Clueless,13700000,56598476,56598476,42898476,1990
1995-01-12,2927,Things to Do in Denver when You're Dead,15000000,529766,529766,-14470234,1990
1995-01-13,3164,Tales from the Crypt: Demon Knight,12000000,21089146,21089146,9089146,1990
1995-01-27,1993,Highlander III: The Sorcerer,26000000,13738574,13738574,-12261426,1990
1995-01-27,4481,Before Sunrise,2500000,5683371,5274005,3183371,1990
1995-02-06,2236,The Bridges of Madison County,22000000,175516617,71516617,153516617,1990
1995-03-02,4191,The Jerky Boys,4000000,7555256,7555256,3555256,1990
1995-03-11,1104,Fair Game,50000000,26097497,11497497,-23902503,1990
1995-03-11,2416,Home for the Holidays,20000000,22119269,17468887,2119269,1990
1995-03-31,3007,Jefferson in Paris,14000000,2461628,2461628,-11538372,1990
1995-04-08,1740,Babe,30000000,246100000,63658910,216100000,1990
1995-04-08,1801,Virtuosity,30000000,23998226,23998226,-6001774,1990
1995-04-21,1398,Kiss of Death,40000000,14942422,14942422,-25057578,1990
1995-04-26,4268,Friday,3500000,27936778,27467564,24436778,1990
1995-05-19,409,Die Hard: With a Vengeance,90000000,366101666,100012499,276101666,1990
1995-05-24,627,Braveheart,72000000,209045522,75545647,137045522,1990
1995-05-24,3855,Tales from the Hood,6000000,11784569,11784569,5784569,1990
1995-05-26,919,Casper,55000000,282300000,100328194,227300000,1990
1995-06-10,1077,Assassins,50000000,83306268,30306268,33306268,1990
1995-06-16,328,Batman Forever,100000000,336529144,184031112,236529144,1990
1995-06-16,5190,The Incredibly True Adventure of Two Girls in Love,250000,2477155,2210408,2227155,1990
1995-06-30,470,Judge Dredd,85000000,113487912,34687912,28487912,1990
1995-06-30,710,Apollo 13,65000000,334100000,172070496,269100000,1990
1995-07-04,1909,Rob Roy,28000000,31390587,31390587,3390587,1990
1995-07-04,2088,Don Juan DeMarco,25000000,22032635,22032635,-2967365,1990
1995-07-04,2199,Bad Boys,23000000,141247413,65647413,118247413,1990
1995-07-07,605,First Knight,75000000,127361412,37361412,52361412,1990
1995-07-07,1534,Species,35000000,113354449,60054449,78354449,1990
1995-07-14,828,Under Siege 2: Dark Territory,60000000,104324083,50024083,44324083,1990
1995-07-14,1200,The Indian in the Cupboard,45000000,35627222,35627222,-9372778,1990
1995-07-21,4713,Kids,1500000,20412216,7412216,18912216,1990
1995-07-28,93,Waterworld,175000000,264246220,88246220,89246220,1990
1995-07-28,2242,The Net,22000000,110521733,50621733,88521733,1990
1995-08-16,3842,The Usual Suspects,6000000,34449356,23341568,28449356,1990
1995-08-18,2327,Mortal Kombat,20000000,122133227,70433227,102133227,1990
1995-08-25,2193,The Princess and the Cobbler,24000000,669276,669276,-23330724,1990
1995-08-25,3722,Desperado,7000000,25532388,25532388,18532388,1990
1995-09-06,1026,Congo,50000000,152022333,81022333,102022333,1990
1995-09-08,5329,The Brothers McMullen,50000,10426506,10426506,10376506,1990
1995-09-22,1391,Showgirls,40000000,37750754,20350754,-2249246,1990
1995-09-22,1722,Se7en,30000000,328125643,100125643,298125643,1990
1995-09-27,2400,To Die For,20000000,27688744,21284514,7688744,1990
1995-09-29,3998,Halloween: The Curse of Michael Myers,5000000,15126948,15126948,10126948,1990
1995-10-02,1680,The Quick and the Dead,32000000,18552460,18552460,-13447540,1990
1995-10-03,1034,Outbreak,50000000,67823573,67823573,17823573,1990
1995-10-06,911,Pocahontas,55000000,347100000,141579773,292100000,1990
1995-10-11,1717,Ace Ventura: When Nature Calls,30000000,212400000,108360063,182400000,1990
1995-10-13,1107,The Scarlet Letter,50000000,10359006,10359006,-39640994,1990
1995-10-13,1109,Jade,50000000,9812870,9812870,-40187130,1990
1995-10-20,1703,Get Shorty,30250000,115021008,72021008,84771008,1990
1995-10-20,3827,Mallrats,6100000,2108367,2108367,-3991633,1990
1995-10-27,2371,Copycat,20000000,32051917,32051917,12051917,1990
1995-10-27,2982,Vampire in Brooklyn,14000000,19637147,19637147,5637147,1990
1995-10-27,4168,Leaving Las Vegas,4000000,49800000,31983777,45800000,1990
1995-11-12,2718,Sense and Sensibility,16500000,134993774,42993774,118493774,1990
1995-11-17,764,The American President,62000000,107822813,60022813,45822813,1990
1995-11-17,784,Goldeneye,60000000,356429941,106429941,296429941,1990
1995-11-22,694,Money Train,68000000,77224232,35324232,9224232,1990
1995-11-22,991,Casino,52000000,110400000,42438300,58400000,1990
1995-11-22,1705,Toy Story,30000000,364545516,191796233,334545516,1990
1995-12-05,922,Crimson Tide,55000000,159387195,91387195,104387195,1990
1995-12-05,3276,The Perez Family,11000000,2794056,2794056,-8205944,1990
1995-12-14,3275,Othello,11000000,2844379,2844379,-8155621,1990
1995-12-15,720,Jumanji,65000000,262758310,100458310,197758310,1990
1995-12-15,885,Sabrina,58000000,87100000,53458319,29100000,1990
1995-12-20,1219,Nixon,45000000,34668249,13668249,-10331751,1990
1995-12-22,393,Cutthroat Island,92000000,18517322,10017322,-73482678,1990
1995-12-25,4197,Four Rooms,4000000,4301000,4301000,301000,1990
1995-12-27,1867,Twelve Monkeys,29000000,168841459,57141459,139841459,1990
1995-12-29,1694,Mr. Holland's Opus,31000000,106282604,82582604,75282604,1990
1995-12-29,2633,Restoration,18000000,4100000,4100000,-13900000,1990
1995-12-29,3251,Dead Man Walking,11000000,83088295,39387284,72088295,1990
1995-12-29,3506,Richard III,9200000,4199334,2684904,-5000666,1990
1995-12-31,3899,Men of War,6000000,0,0,-6000000,1990
1996-01-03,823,Up Close & Personal,60000000,100645801,51045801,40645801,1990
1996-01-04,5379,Bang,10000,527,527,-9473,1990
1996-01-11,2953,Romeo+Juliet,14500000,147542381,46338728,133042381,1990
1996-01-11,3113,The Funeral,12500000,1412799,1212799,-11087201,1990
1996-01-19,2388,From Dusk Till Dawn,20000000,25732986,25728961,5732986,1990
1996-02-02,1236,The Juror,44000000,22730924,22730924,-21269076,1990
1996-02-02,1468,White Squall,38000000,10229300,10229300,-27770700,1990
1996-02-07,573,Independence Day,75000000,817400878,306169255,742400878,1990
1996-02-08,956,Chain Reaction,55000000,60209334,21226204,5209334,1990
1996-02-08,3904,Emma,5900000,37831658,22231658,31931658,1990
1996-02-16,1392,City Hall,40000000,20278055,20278055,-19721945,1990
1996-02-16,3321,Happy Gilmore,10000000,41004412,38623460,31004412,1990
1996-02-21,4055,Bottle Rocket,5000000,407488,407488,-4592512,1990
1996-02-23,1150,Mary Reilly,47000000,12900000,5707094,-34100000,1990
1996-02-23,2638,Unforgettable,18000000,2483790,2483790,-15516210,1990
1996-02-23,3679,Rumble in the Bronx,7500000,36238752,32281907,28738752,1990
1996-03-04,3607,A Thin Line Between Love & Hate,8000000,34873513,34873513,26873513,1990
1996-03-05,2853,The Craft,15000000,55669466,24769466,40669466,1990
1996-03-05,3634,The Pallbearer,8000000,5656388,5656388,-2343612,1990
1996-03-15,936,Executive Decision,55000000,122079192,56679192,67079192,1990
1996-03-22,3194,Girl 6,12000000,4880941,4880941,-7119059,1990
1996-03-22,3732,Flirting with Disaster,7000000,16149180,14853474,9149180,1990
1996-03-29,1440,Sgt. Bilko,39000000,37956589,30356589,-1043411,1990
1996-04-10,1210,The Glimmer Man,45000000,36404841,20404841,-8595159,1990
1996-04-10,3417,Crash,10000000,3357324,3357324,-6642676,1990
1996-04-10,4120,Bound,4500000,7011317,3802260,2511317,1990
1996-04-10,4473,That Thing You Do!,2500000,34557416,25857416,32057416,1990
1996-04-19,1625,Le hussard sur le toit,35000000,1320043,1320043,-33679957,1990
1996-04-19,2129,Mrs. Winterbourne,25000000,10039566,10039566,-14960434,1990
1996-05-04,3080,Faithful,13000000,2104439,2104439,-10895561,1990
1996-05-07,1663,Phenomenon,32000000,152036382,104636382,120036382,1990
1996-05-17,2003,Flipper,25530000,30593313,20080020,5063313,1990
1996-05-21,488,Mission: Impossible,80000000,457697994,180981886,377697994,1990
1996-05-24,2593,Spy Hard,18000000,26936265,26936265,8936265,1990
1996-05-31,899,Dragonheart,57000000,104364680,51364680,47364680,1990
1996-06-09,1686,Bogus,32000000,4357406,4357406,-27642594,1990
1996-06-11,3516,Set It Off,9000000,36049108,36049108,27049108,1990
1996-06-12,541,Daylight,80000000,158908290,32908290,78908290,1990
1996-06-12,2452,Everyone Says I Love You,20000000,34600000,9725847,14600000,1990
1996-06-14,1144,The Cable Guy,47000000,102825796,60240295,55825796,1990
1996-06-21,340,Eraser,100000000,234400000,101295562,134400000,1990
1996-06-21,341,The Hunchback of Notre Dame,100000000,325500000,100138851,225500000,1990
1996-06-21,4009,Lone Star,5000000,12961389,12961389,7961389,1990
1996-06-28,913,The Nutty Professor,55000000,273814019,128814019,218814019,1990
1996-06-28,1074,Striptease,50000000,113309743,33109743,63309743,1990
1996-07-06,583,The Rock,75000000,336069511,134069511,261069511,1990
1996-07-06,1214,The Phantom,45000000,17220599,17220599,-27779401,1990
1996-07-17,1211,Multiplicity,45000000,20133326,20133326,-24866674,1990
1996-07-17,4875,Walking and Talking,1000000,1615787,1287480,615787,1990
1996-07-19,1818,Fled,30000000,19892205,17192205,-10107795,1990
1996-07-19,4328,Trainspotting,3100000,71558971,16501785,68458971,1990
1996-07-24,1288,A Time to Kill,40000000,152266007,108766007,112266007,1990
1996-07-26,2083,Kingpin,25000000,32223424,25023424,7223424,1990
1996-07-26,2103,The Adventures of Pinocchio,25000000,36682170,15382170,11682170,1990
1996-07-26,4595,Stonewall,2000000,304602,304602,-1695398,1990
1996-08-03,3724,Fargo,7000000,51204567,24567751,44204567,1990
1996-08-11,641,Ransom,70000000,308700000,136492681,238700000,1990
1996-08-16,957,The Fan,55000000,18582965,18582965,-36417035,1990
1996-08-16,1188,Tin Cup,45000000,75854588,53854588,30854588,1990
1996-08-16,2554,Kansas City,19000000,1353824,1353824,-17646176,1990
1996-08-23,1377,The Island of Dr. Moreau,40000000,27682712,27682712,-12317288,1990
1996-08-23,4278,She's the One,3500000,13795053,9482579,10295053,1990
1996-08-23,4399,Freeway,3000000,295493,295493,-2704507,1990
1996-09-02,726,Broken Arrow,65000000,148345997,70645997,83345997,1990
1996-09-08,1088,Escape from L.A.,50000000,25426861,25426861,-24573139,1990
1996-09-08,1185,Jack,45000000,58617334,58617334,13617334,1990
1996-09-08,4386,Basquiat,3000000,2962051,2962051,-37949,1990
1996-09-13,2110,Maximum Risk,25000000,51702929,14102929,26702929,1990
1996-09-20,701,Last Man Standing,67000000,18115927,18115927,-48884073,1990
1996-09-20,1720,The First Wives Club,30000000,181489203,105489203,151489203,1990
1996-09-20,5160,When The Cat's Away,300000,2525984,1652472,2225984,1990
1996-09-27,1465,Extreme Measures,38000000,17378193,17378193,-20621807,1990
1996-09-28,4117,Secrets & Lies,4500000,13417292,13417292,8917292,1990
1996-10-05,434,Twister,88000000,495700000,241688385,407700000,1990
1996-10-05,4981,Welcome to the Dollhouse,800000,5034794,4198137,4234794,1990
1996-10-07,3054,Harriet the Spy,13000000,26570048,26570048,13570048,1990
1996-10-16,4509,Get on the Bus,2400000,5691854,5691854,3291854,1990
1996-10-18,1234,Sleepers,44000000,165600852,53300852,121600852,1990
1996-10-18,5231,Swingers,200000,6618578,4505922,6418578,1990
1996-10-25,2986,Thinner,14000000,15171475,15171475,1171475,1990
1996-11-10,742,The Long Kiss Goodnight,65000000,33447612,33447612,-31552388,1990
1996-11-10,946,The Ghost and the Darkness,55000000,38564422,38564422,-16435578,1990
1996-11-10,2122,Michael Collins,25000000,27572844,11092559,2572844,1990
1996-11-10,4770,Trees Lounge,1300000,749741,749741,-550259,1990
1996-11-15,515,Space Jam,80000000,250200000,90463534,170200000,1990
1996-11-15,1257,The Mirror Has Two Faces,42000000,41267469,41267469,-732531,1990
1996-11-15,1525,The English Patient,35000000,231711151,78716374,196711151,1990
1996-11-20,4096,Sling Blade,4833610,34175000,24475416,29341390,1990
1996-11-22,814,Jingle All the Way,60000000,129832389,60592389,69832389,1990
1996-11-22,1154,Star Trek: First Contact,46000000,150000000,92027888,104000000,1990
1996-11-22,3924,Shine,5500000,36665191,35811509,31165191,1990
1996-12-01,2385,Eye for an Eye,20000000,26792700,26792700,6792700,1990
1996-12-07,1157,Courage Under Fire,46000000,100833145,59003384,54833145,1990
1996-12-07,3766,Les Visiteurs,7000000,98754000,659000,91754000,1990
1996-12-13,537,Mars Attacks!,80000000,101371017,37771017,21371017,1990
1996-12-13,1006,Jerry Maguire,50000000,274000000,153952592,224000000,1990
1996-12-20,1501,Ghosts of Mississippi,36000000,13052741,13052741,-22947259,1990
1996-12-20,2215,Marvin's Room,23000000,12803305,12803305,-10196695,1990
1996-12-20,2282,My Fellow Americans,21500000,22331846,22331846,831846,1990
1996-12-20,2796,Scream,15000000,173046663,103046663,158046663,1990
1996-12-20,3135,Beavis and Butt-head Do America,12000000,63118386,63118386,51118386,1990
1996-12-25,942,Evita,55000000,151947179,50047179,96947179,1990
1996-12-25,2631,Hamlet,18000000,7129670,4501094,-10870330,1990
1996-12-31,2934,Silent Trigger,15000000,76382,76382,-14923618,1990
1997-01-07,395,Men in Black,90000000,587790539,250690539,497790539,1990
1997-01-08,4340,Air Bud,3000000,27788649,24646936,24788649,1990
1997-01-08,5357,In the Company of Men,25000,2883661,2883661,2858661,1990
1997-01-17,4057,Albino Alligator,5000000,353480,353480,-4646520,1990
1997-01-24,3647,Prefontaine,8000000,590817,590817,-7409183,1990
1997-01-31,1229,Shadow Conspiracy,45000000,2154540,2154540,-42845460,1990
1997-01-31,4201,Waiting for Guffman,4000000,2922988,2922988,-1077012,1990
1997-02-05,1495,Breakdown,36000000,50159144,50159144,14159144,1990
1997-02-05,1617,Warriors of Virtue,35000000,6448817,6448817,-28551183,1990
1997-02-05,2579,Austin Powers: International Man of Mystery,18000000,67683989,53883989,49683989,1990
1997-02-14,1050,Absolute Power,50000000,50068310,50068310,68310,1990
1997-02-21,1997,Blood and Wine,26000000,1083350,1083350,-24916650,1990
1997-02-28,1548,Donnie Brasco,35000000,65303052,41954997,30303052,1990
1997-02-28,1622,Smilla's Sense of Snow,35000000,2221994,2221994,-32778006,1990
1997-02-28,4376,Kama Sutra,3000000,4109095,4109095,1109095,1990
1997-03-10,1940,Kiss the Girls,27000000,60527873,60527873,33527873,1990
1997-03-14,3381,Love Jones,10000000,12554569,12554569,2554569,1990
1997-03-21,1159,Liar Liar,45000000,302710615,181410615,257710615,1990
1997-03-21,2363,Selena,20000000,35450113,35450113,15450113,1990
1997-03-26,428,The Devil's Own,90000000,140900000,42885593,50900000,1990
1997-03-26,1687,Cats Don't Dance,32000000,3588602,3588602,-28411398,1990
1997-03-28,5194,Love and Other Catastrophes,250000,743216,212285,493216,1990
1997-04-04,423,The Saint,90000000,169400000,61363304,79400000,1990
1997-04-04,5186,Chasing Amy,250000,15155095,12006514,14905095,1990
1997-04-18,1268,McHale's Navy,42000000,4408420,4408420,-37591580,1990
1997-04-18,4381,8 Heads in a Duffel Bag,3000000,4002884,3602884,1002884,1990
1997-04-25,427,Volcano,90000000,120100000,47546796,30100000,1990
1997-05-03,5166,The Watermelon Woman,300000,42735,42735,-257265,1990
1997-05-12,3303,Good Will Hunting,10000000,225933435,138433435,215933435,1990
1997-05-22,576,The Lost World: Jurassic Park,75000000,618638999,229086679,543638999,1990
1997-06-06,509,Con Air,80000000,224117573,101117573,144117573,1990
1997-06-08,3173,Def Jam's How To Be a Player,12000000,14010363,14010363,2010363,1990
1997-06-13,304,Speed 2: Cruise Control,110000000,150468000,48097081,40468000,1990
1997-06-13,648,Hercules,70000000,250700000,99112101,180700000,1990
1997-06-13,4450,Ulee's Gold,2700000,15600000,9054736,12900000,1990
1997-06-20,248,Batman & Robin,125000000,238317814,107325195,113317814,1990
1997-06-20,1152,My Best Friend's Wedding,46000000,298923419,126813153,252923419,1990
1997-06-20,4231,The Last Time I Committed Suicide,4000000,12836,12836,-3987164,1990
1997-06-20,4888,Dream With The Fishes,1000000,542909,542909,-457091,1990
1997-06-27,503,Face/Off,80000000,241200000,112276146,161200000,1990
1997-07-02,277,Dante's Peak,115000000,178200000,67163857,63200000,1990
1997-07-11,353,Starship Troopers,100000000,121100000,54768952,21100000,1990
1997-07-11,1106,Mad City,50000000,10561038,10561038,-39438962,1990
1997-07-11,4000,Eve's Bayou,5000000,14843425,14843425,9843425,1990
1997-07-16,916,George Of The Jungle,55000000,174463257,105263257,119463257,1990
1997-07-18,2049,Nothing To Lose,25000000,64594061,44480039,39594061,1990
1997-07-25,443,Air Force One,85000000,315268353,172956409,230268353,1990
1997-07-31,1330,Spawn,40000000,87949859,54979992,47949859,1990
1997-08-08,520,Conspiracy Theory,80000000,142783718,76118990,62783718,1990
1997-08-10,669,Seven Years in Tibet,70000000,131445884,37945884,61445884,1990
1997-08-13,4266,The Full Monty,3500000,257938649,45950122,254438649,1990
1997-08-15,859,Event Horizon,60000000,26673242,26673242,-33326758,1990
1997-08-15,2769,Steel,16000000,1686429,1686429,-14313571,1990
1997-08-15,2817,Cop Land,15000000,63706632,44906632,48706632,1990
1997-08-22,1053,G.I. Jane,50000000,48169156,48169156,-1830844,1990
1997-08-22,2053,Money Talks,25000000,41076865,41076865,16076865,1990
1997-08-22,5113,Sunday,450000,450349,410919,349,1990
1997-08-24,1999,The Grimm Brothers' Snow White,26000000,5000,5000,-25995000,1990
1997-09-05,377,The Fifth Element,95000000,263900000,63570862,168900000,1990
1997-09-05,474,Father's Day,85000000,35681080,28681080,-49318920,1990
1997-09-19,1529,L.A. Confidential,35000000,126204977,64604977,91204977,1990
1997-09-19,1531,In & Out,35000000,83226569,63826569,48226569,1990
1997-09-26,1062,The Peacemaker,50000000,62967368,41263140,12967368,1990
1997-09-26,2620,The Ice Storm,18000000,16011975,8038061,-1988025,1990
1997-09-26,3678,Soul Food,7500000,43492389,43492389,35992389,1990
1997-10-01,848,The Relic,60000000,33956608,33956608,-26043392,1990
1997-10-01,961,Turbulence,55000000,11532774,11532774,-43467226,1990
1997-10-10,2850,Boogie Nights,15000000,43111725,26410771,28111725,1990
1997-10-10,4038,The Sweet Hereafter,5000000,7951247,4306697,2951247,1990
1997-10-17,897,Devil's Advocate,57000000,153007424,61007424,96007424,1990
1997-10-17,2669,I Know What You Did Last Summer,17000000,125250091,72250091,108250091,1990
1997-10-24,1502,Gattaca,36000000,12532777,12532777,-23467223,1990
1997-10-31,1470,Switchback,38000000,6504442,6504442,-31495558,1990
1997-10-31,3214,Critical Care,12000000,220175,220175,-11779825,1990
1997-11-04,1181,Anaconda,45000000,136998907,65598907,91998907,1990
1997-11-04,2847,Grosse Pointe Blank,15000000,31070412,28084357,16070412,1990
1997-11-04,5372,Pink Flamingos,12000,413802,413802,401802,1990
1997-11-07,407,Contact,90000000,165900000,100920329,75900000,1990
1997-11-07,1923,A Simple Wish,28000000,8165213,8165213,-19834787,1990
1997-11-14,821,The Jackal,60000000,159356941,54956941,99356941,1990
1997-11-14,980,Anastasia,53000000,139801290,58403409,86801290,1990
1997-11-14,2432,The Man Who Knew Too Little,20000000,13801755,13801755,-6198245,1990
1997-11-21,1345,The Rainmaker,40000000,45916769,45916769,5916769,1990
1997-11-21,1578,Midnight in the Garden of Good and Evil,35000000,25078937,25078937,-9921063,1990
1997-11-21,1785,Mortal Kombat: Annihilation,30000000,51327406,35927406,21327406,1990
1997-11-26,513,Flubber,80000000,177993801,92993801,97993801,1990
1997-11-26,830,Alien: Resurrection,60000000,160700000,47795018,100700000,1990
1997-12-09,1052,The Game,50000000,80369970,48265581,30369970,1990
1997-12-12,1347,Amistad,40000000,58250151,44212592,18250151,1990
1997-12-12,2165,Scream 2,24000000,101363301,101363301,77363301,1990
1997-12-12,2449,Deconstructing Harry,20000000,10686841,10686841,-9313159,1990
1997-12-17,3987,The Apostle,5000000,21277770,20733485,16277770,1990
1997-12-19,37,Titanic,200000000,2207615668,658672302,2007615668,1990
1997-12-19,290,Tomorrow Never Dies,110000000,339504276,125304276,229504276,1990
1997-12-19,1451,Mouse Hunt,38000000,61894591,61894591,23894591,1990
1997-12-24,1008,As Good as it Gets,50000000,314111923,148478011,264111923,1990
1997-12-25,550,The Postman,80000000,20841123,17650704,-59158877,1990
1997-12-25,1925,Kundun,28000000,5686694,5686694,-22313306,1990
1997-12-25,2818,Wag the Dog,15000000,64252038,43057470,49252038,1990
1997-12-25,3139,Jackie Brown,12000000,74727492,39673162,62727492,1990
1997-12-31,3112,Oscar and Lucinda,12500000,1612957,1612957,-10887043,1990
1998-01-05,2090,He Got Game,25000000,22411948,21567853,-2588052,1990
1998-01-05,4216,Shooting Fish,4000000,302204,302204,-3697796,1990
1998-01-05,4518,"Dancer, Texas Pop. 81",2300000,574838,574838,-1725162,1990
1998-01-07,182,Armageddon,140000000,554600000,201578182,414600000,1990
1998-01-16,677,Hard Rain,70000000,19870567,19870567,-50129433,1990
1998-01-16,3621,Half Baked,8000000,17394881,17394881,9394881,1990
1998-01-16,4456,The Dress,2650000,16556,16556,-2633444,1990
1998-01-23,2077,Spice World,25000000,56042592,29342592,31042592,1990
1998-01-30,1222,Deep Rising,45000000,11203026,11203026,-33796974,1990
1998-01-30,4048,Zero Effect,5000000,2080693,2080693,-2919307,1990
1998-02-10,530,What Dreams May Come,80000000,71485043,55485043,-8514957,1990
1998-02-10,792,Antz,60000000,152457863,90757863,92457863,1990
1998-02-10,2685,A Night at the Roxbury,17000000,30331165,30331165,13331165,1990
1998-02-13,621,Sphere,73000000,50168294,37068294,-22831706,1990
1998-02-13,1871,The Borrowers,29000000,54045832,22619589,25045832,1990
1998-02-13,5065,Hurricane Streets,500000,367582,334041,-132418,1990
1998-02-20,5321,I Love You … Don't Touch Me!,68000,33598,33598,-34402,1990
1998-02-27,1951,Dark City,27000000,27257061,14435076,257061,1990
1998-02-27,3468,An Alan Smithee Film: Burn Hollywood Burn,10000000,45779,45779,-9954221,1990
1998-03-04,524,Lost In Space,80000000,136047317,69117629,56047317,1990
1998-03-04,849,Mercury Rising,60000000,32983332,32983332,-27016668,1990
1998-03-04,2885,Barney's Great Adventure,15000000,11156471,11156471,-3843529,1990
1998-03-04,3387,The Spanish Prisoner,10000000,13835130,10162034,3835130,1990
1998-03-13,1537,The Man in the Iron Mask,35000000,56968169,56968169,21968169,1990
1998-03-13,3771,Chairman of the Board,7000000,306715,306715,-6693285,1990
1998-03-20,739,Primary Colors,65000000,39017984,39017984,-25982016,1990
1998-03-20,2380,Wild Things,20000000,55576699,29795299,35576699,1990
1998-03-20,3234,Madadayo,11900000,48856,48856,-11851144,1990
1998-03-20,3852,Mr. Nice Guy,6000000,31716953,12716953,25716953,1990
1998-03-27,1956,The Newton Boys,27000000,10341093,10341093,-16658907,1990
1998-03-27,2192,Meet the Deedles,24000000,4356126,4356126,-19643874,1990
1998-03-27,2507,"Couloirs du temps: Les visiteurs 2, Les",20000000,26146072,146072,6146072,1990
1998-03-27,4062,No Looking Back,5000000,143273,143273,-4856727,1990
1998-03-27,4128,Karakter,4500000,713413,713413,-3786587,1990
1998-04-09,1606,Knock Off,35000000,10319915,10319915,-24680085,1990
1998-04-12,2398,Psycho,20000000,37226218,21541218,17226218,1990
1998-04-12,3868,Little Voice,6000000,21787233,4595000,15787233,1990
1998-04-15,4602,24 7: Twenty Four Seven,2000000,72544,72544,-1927456,1990
1998-04-17,2845,The Object of my Affection,15000000,29145924,29145924,14145924,1990
1998-04-24,3052,The Big Hit,13000000,27066941,27066941,14066941,1990
1998-04-24,3854,Sliding Doors,6000000,58809149,11911200,52809149,1990
1998-04-24,4871,Two Girls and a Guy,1000000,2315026,2057193,1315026,1990
1998-05-06,780,The Truman Show,60000000,264118201,125618201,204118201,1990
1998-05-08,2675,Halloween: H2O,17000000,55041738,55041738,38041738,1990
1998-05-15,804,The Horse Whisperer,60000000,186883563,75383563,126883563,1990
1998-05-15,1386,Quest for Camelot,40000000,38172500,22772500,-1827500,1990
1998-05-15,1799,Bulworth,30000000,29203383,26528684,-796617,1990
1998-05-15,4591,Clockwatchers,2000000,539961,537948,-1460039,1990
1998-05-19,245,Godzilla,125000000,376000000,136314294,251000000,1990
1998-05-22,2561,Fear and Loathing in Las Vegas,18500000,13711903,10680275,-4788097,1990
1998-05-27,4277,I Got the Hook-Up!,3500000,10317779,10317779,6817779,1990
1998-05-29,1746,Hope Floats,30000000,81529000,60110313,51529000,1990
1998-06-02,1811,The Replacement Killers,30000000,19035741,19035741,-10964259,1990
1998-06-03,2427,Twilight,20000000,15055091,15055091,-4944909,1990
1998-06-03,2866,The Big Lebowski,15000000,46189568,17498804,31189568,1990
1998-06-03,4160,Love and Death on Long Island,4030000,2542264,2542264,-1487736,1990
1998-06-11,666,The Siege,70000000,116625798,40934175,46625798,1990
1998-06-11,2075,Elizabeth,25000000,82150642,30082699,57150642,1990
1998-06-11,2197,The Waterboy,23000000,190191646,161491646,167191646,1990
1998-06-11,3545,Velvet Goldmine,9000000,4313644,1053788,-4686356,1990
1998-06-11,4280,Gods and Monsters,3500000,6451628,6451628,2951628,1990
1998-06-19,404,Mulan,90000000,303500000,120620254,213500000,1990
1998-06-19,704,The X Files: Fight the Future,66000000,189176423,83898313,123176423,1990
1998-06-19,5019,Hav Plenty,650000,2301777,2301777,1651777,1990
1998-06-26,633,Doctor Dolittle,71500000,294156605,144156605,222656605,1990
1998-06-26,1138,Out of Sight,48000000,77562568,37562568,29562568,1990
1998-06-26,4561,Smoke Signals,2000000,7756617,6719300,5756617,1990
1998-06-26,4721,Buffalo '66,1500000,2380606,2380606,880606,1990
1998-07-08,620,Snake Eyes,73000000,103891409,55591409,30891409,1990
1998-07-08,4910,Safe Men,1000000,21210,21210,-978790,1990
1998-07-08,5171,"First Love, Last Rites",300000,10876,10876,-289124,1990
1998-07-15,2232,There's Something About Mary,22000000,360099999,176484651,338099999,1990
1998-07-17,721,The Mask of Zorro,65000000,233700000,93828745,168700000,1990
1998-07-22,967,Lolita,55000000,1147784,1147784,-53852216,1990
1998-07-24,706,Saving Private Ryan,65000000,485035085,216335085,420035085,1990
1998-07-24,2865,Disturbing Behavior,15000000,19014238,17507368,4014238,1990
1998-07-24,3361,Jane Austen's Mafia,10000000,30143795,19843795,20143795,1990
1998-07-29,1058,The Negotiator,50000000,49105766,44705766,-894234,1990
1998-07-31,1973,Ever After: A Cinderella Story,26000000,65705772,65705772,39705772,1990
1998-08-04,3982,The Players Club,5000000,23047939,23047939,18047939,1990
1998-08-05,495,Deep Impact,80000000,349464664,140464664,269464664,1990
1998-08-05,3070,Woo,13000000,8064972,8064972,-4935028,1990
1998-08-14,862,The Avengers,60000000,48585416,23385416,-11414584,1990
1998-08-14,2356,How Stella Got Her Groove Back,20000000,37672944,37672944,17672944,1990
1998-08-14,3451,La femme de chambre du Titanic,10000000,244465,244465,-9755535,1990
1998-08-14,4031,Slums of Beverly Hills,5000000,5502773,5502773,502773,1990
1998-08-21,1177,Blade,45000000,131237688,70141876,86237688,1990
1998-08-21,2987,Dead Man on Campus,14000000,15064948,15064948,1064948,1990
1998-08-21,4865,"Next Stop, Wonderland",1000000,3465703,3395581,2465703,1990
1998-08-28,3064,54,13000000,16757163,16757163,3757163,1990
1998-08-28,5195,I Married a Strange Person,250000,203134,203134,-46866,1990
1998-09-01,2549,Firestorm,19000000,8123860,8123860,-10876140,1990
1998-09-10,871,Holy Man,60000000,12069719,12069719,-47930281,1990
1998-09-10,4769,Festen,1300000,1647780,1647780,347780,1990
1998-09-10,4878,Slam,1000000,1087521,1009819,87521,1990
1998-09-10,5300,The Mighty,100000,6121582,2652246,6021582,1990
1998-09-18,1514,Rush Hour,35000000,245300000,141186864,210300000,1990
1998-09-18,1802,One True Thing,30000000,26708196,23337196,-3291804,1990
1998-09-18,4598,Six-String Samurai,2000000,134624,134624,-1865376,1990
1998-09-25,944,Ronin,55000000,70692101,41610884,15692101,1990
1998-09-25,2970,Urban Legend,14000000,72571864,38116707,58571864,1990
1998-09-25,3643,Clay Pigeons,8000000,2256606,1793359,-5743394,1990
1998-09-25,4909,The Last Big Thing,1000000,22434,22434,-977566,1990
1998-10-04,925,City of Angels,55000000,198750909,78750909,143750909,1990
1998-10-07,186,Lethal Weapon 4,140000000,285400000,130444603,145400000,1990
1998-10-07,1329,Small Soldiers,40000000,71743823,55143823,31743823,1990
1998-10-07,5320,Pi,68000,4678513,3221152,4610513,1990
1998-10-16,832,Practical Magic,60000000,68336997,46850558,8336997,1990
1998-10-16,985,Beloved,53000000,22852487,22852487,-30147513,1990
1998-10-16,2070,Bride of Chucky,25000000,50692188,32404188,25692188,1990
1998-10-16,4389,Happiness,3000000,5746453,2746453,2746453,1990
1998-10-23,612,Soldier,75000000,14623082,14623082,-60376918,1990
1998-10-23,4884,Orgazmo,1000000,627287,582024,-372713,1990
1998-10-30,2402,Vampires,20000000,20268825,20268825,268825,1990
1998-10-30,3175,Living Out Loud,12000000,12905901,12905901,905901,1990
1998-10-30,3404,American History X,10000000,6719864,6719864,-3280136,1990
1998-11-09,2149,Without Limits,25000000,780326,780326,-24219674,1990
1998-11-09,2412,Simon Birch,20000000,18310591,18253415,-1689409,1990
1998-11-09,3158,Rounders,12000000,22921898,22921898,10921898,1990
1998-11-09,5162,Let's Talk About Sex,300000,373615,373615,73615,1990
1998-11-09,5193,Cube,250000,8969065,489220,8719065,1990
1998-11-12,656,Star Trek: Insurrection,70000000,117800000,70187658,47800000,1990
1998-11-12,1072,Jack Frost,50000000,34645374,34645374,-15354626,1990
1998-11-12,1969,Shakespeare in Love,26000000,279500000,100317794,253500000,1990
1998-11-12,2693,A Simple Plan,17000000,16316273,16316273,-683727,1990
1998-11-12,3367,Rushmore,10000000,19080435,17105219,9080435,1990
1998-11-13,467,Meet Joe Black,85000000,44650003,44650003,-40349997,1990
1998-11-13,2174,I Still Know What You Did Last Summer,24000000,40020622,40020622,16020622,1990
1998-11-20,453,Enemy of the State,85000000,250649836,111549836,165649836,1990
1998-11-20,1160,A Bug's Life,45000000,363095319,162798565,318095319,1990
1998-11-20,1884,The Rugrats Movie,28000000,140894685,100494685,112894685,1990
1998-11-20,3191,Celebrity,12000000,6200000,5078660,-5800000,1990
1998-11-20,4339,Waking Ned Devine,3000000,55193251,24793251,52193251,1990
1998-11-20,4435,Central do Brasil,2900000,17006158,5969553,14106158,1990
1998-11-25,549,Babe: Pig in the City,80000000,69131860,18319860,-10868140,1990
1998-11-25,2887,Home Fries,15000000,10513979,10513979,-4486021,1990
1998-11-25,3389,Very Bad Things,10000000,21094974,9949470,11094974,1990
1998-12-06,521,"Six Days, Seven Nights",80000000,164800000,74339294,84800000,1990
1998-12-06,3069,Dirty Work,13000000,10020081,10020081,-2979919,1990
1998-12-06,3351,Can't Hardly Wait,10000000,25358996,25358996,15358996,1990
1998-12-06,3654,The Land Girls,8000000,146083,146083,-7853917,1990
1998-12-18,715,You've Got Mail,65000000,250800000,115821495,185800000,1990
1998-12-18,788,The Prince of Egypt,60000000,218613188,101413188,158613188,1990
1998-12-23,993,The Thin Red Line,52000000,97709034,36400491,45709034,1990
1998-12-25,531,Mighty Joe Young,80000000,50632037,50632037,-29367963,1990
1998-12-25,818,A Civil Action,60000000,56709981,56709981,-3290019,1990
1998-12-25,1009,Patch Adams,50000000,202173000,135014968,152173000,1990
1998-12-25,1020,Stepmom,50000000,159745279,91137662,109745279,1990
1998-12-25,2823,The Faculty,15000000,40283321,40283321,25283321,1990
1998-12-25,3450,The Swindle,10000000,5045359,245359,-4954641,1990
1999-01-09,1638,Chill Factor,34000000,11263966,11263966,-22736034,1990
1999-01-09,3745,Outside Providence,7000000,7824358,7309628,824358,1990
1999-01-10,1131,Three Kings,48000000,107752036,60652036,59752036,1990
1999-01-10,1921,"Mystery, Alaska",28000000,8891623,8891623,-19108377,1990
1999-01-10,2696,The Adventures of Elmo in Grouchland,17000000,11634458,11634458,-5365542,1990
1999-01-10,3619,Drive Me Crazy,8000000,22591451,17843379,14591451,1990
1999-01-10,4689,"Happy, Texas",1700000,2891228,2039192,1191228,1990
1999-01-15,613,Virus,75000000,30626690,14010690,-44373310,1990
1999-01-15,1388,At First Sight,40000000,22365133,22365133,-17634867,1990
1999-01-15,1830,In Dreams,30000000,12017369,12017369,-17982631,1990
1999-01-15,2729,Varsity Blues,16000000,54294169,52894169,38294169,1990
1999-01-15,4702,Mississippi Mermaid,1600000,2627795,27795,1027795,1990
1999-01-22,1842,Gloria,30000000,4967493,4167493,-25032507,1990
1999-01-22,5259,Bacheha-Ye aseman,180000,1628579,933933,1448579,1990
1999-01-29,3310,She's All That,10000000,63465522,63465522,53465522,1990
1999-02-04,1376,The Out-of-Towners,40000000,28544120,28544120,-11455880,1990
1999-02-04,5387,Following,6000,240495,48482,234495,1990
1999-02-07,2258,Summer of Sam,22000000,19288130,19288130,-2711870,1990
1999-02-07,5033,Broken Vessels,600000,85343,15030,-514657,1990
1999-02-19,3385,Office Space,10000000,12179708,10827813,2179708,1990
1999-02-19,4385,Jawbreaker,3000000,3076820,3076820,76820,1990
1999-02-26,1360,8MM,40000000,96398826,36443442,56398826,1990
1999-02-26,3861,200 Cigarettes,6000000,6852450,6852450,852450,1990
1999-02-26,5322,20 Dates,66000,602920,541636,536920,1990
1999-03-12,2218,The End of the Affair,23000000,10660147,10660147,-12339853,1990
1999-03-19,3202,Ravenous,12000000,2062406,2062406,-9937594,1990
1999-03-19,4919,Sparkler,1000000,5494,5494,-994506,1990
1999-03-26,864,EDtv,60000000,35319689,22508689,-24680311,1990
1999-03-26,3001,A Walk on the Moon,14000000,4741987,4741987,-9258013,1990
1999-03-26,3990,Doug's 1st Movie,5000000,19421271,19421271,14421271,1990
1999-03-26,4226,Among Giants,4000000,64359,64359,-3935641,1990
1999-03-31,711,The Matrix,65000000,463517383,171479930,398517383,1990
1999-03-31,3048,Ten Things I Hate About You,13000000,60414025,38177966,47414025,1990
1999-04-06,950,Instinct,55000000,34105207,34105207,-20894793,1990
1999-04-06,3589,Limbo,8300000,2598224,2160710,-5701776,1990
1999-04-06,4065,Desert Blue,5000000,99147,99147,-4900853,1990
1999-04-08,1091,The Iron Giant,50000000,31333917,23159305,-18666083,1990
1999-04-08,3072,Dick,13000000,6276869,6276869,-6723131,1990
1999-04-08,4409,The Gambler,3000000,101773,51773,-2898227,1990
1999-04-16,595,Life,75000000,73521587,64062587,-1478413,1990
1999-04-23,1653,Pushing Tin,33000000,8408835,8408835,-24591165,1990
1999-04-23,2303,eXistenZ,20700000,2840417,2840417,-17859583,1990
1999-04-23,2997,Lost and Found,14000000,6552255,6552255,-7447745,1990
1999-04-23,3577,Election,8500000,17202854,14943582,8702854,1990
1999-04-30,703,Entrapment,66000000,211700000,87707396,145700000,1990
1999-04-30,2913,Idle Hands,15000000,4023741,4023741,-10976259,1990
1999-04-30,4585,Get Real,2000000,1152411,1152411,-847589,1990
1999-05-02,1025,Payback,50000000,161626121,81526121,111626121,1990
1999-05-02,3870,Simply Irresistible,6000000,4398989,4398989,-1601011,1990
1999-05-03,1719,Analyze This,30000000,176885658,106885658,146885658,1990
1999-05-03,3253,Cruel Intentions,11000000,75803716,38230075,64803716,1990
1999-05-03,4766,"Lock, Stock and Two Smoking Barrels",1350000,28356188,3897569,27006188,1990
1999-05-11,697,The Insider,68000000,60265197,28965197,-7734803,1990
1999-05-11,1130,The Bone Collector,48000000,151463090,66488090,103463090,1990
1999-05-11,2295,The Bachelor,21000000,36882378,21731001,15882378,1990
1999-05-14,2988,Tea with Mussolini,14000000,14395874,14395874,395874,1990
1999-05-19,272,Star Wars Ep. I: The Phantom Menace,115000000,1027044677,474544677,912044677,1990
1999-05-21,2900,The Love Letter,15000000,8322608,8322608,-6677392,1990
1999-05-21,5143,Trekkies,375000,617172,617172,242172,1990
1999-05-28,1248,Notting Hill,42000000,363728226,116089678,321728226,1990
1999-05-28,2757,The Thirteenth Floor,16000000,11810854,11810854,-4189146,1990
1999-05-28,4212,The Loss of Sexual Innocence,4000000,399793,399793,-3600207,1990
1999-06-08,696,Mystery Men,68000000,33462011,29762011,-34537989,1990
1999-06-08,1129,The Thomas Crown Affair,48000000,124304264,69304264,76304264,1990
1999-06-08,1276,The Sixth Sense,40000000,672806292,293506292,632806292,1990
1999-06-08,3443,Illuminata,10000000,836641,836641,-9163359,1990
1999-06-16,175,Tarzan,145000000,448191819,171091819,303191819,1990
1999-06-18,787,The General's Daughter,60000000,149705852,102705852,89705852,1990
1999-06-18,3291,An Ideal Husband,10700000,31341183,18542974,20641183,1990
1999-06-18,4680,Lola rennt,1750000,22879194,7267324,21129194,1990
1999-06-25,1707,Big Daddy,30000000,228641283,163479795,198641283,1990
1999-06-30,90,Wild Wild West,175000000,221229335,113805681,46229335,1990
1999-06-30,2285,"South Park: Bigger, Longer & Uncut",21000000,52037603,52037603,31037603,1990
1999-07-05,492,The Mummy,80000000,416385488,155385488,336385488,1990
1999-07-14,2185,Muppets From Space,24000000,16304786,16304786,-7695214,1990
1999-07-14,5026,The Blair Witch Project,600000,248300000,140539099,247700000,1990
1999-07-16,731,Eyes Wide Shut,65000000,104267443,55691208,39267443,1990
1999-07-16,1947,Lake Placid,27000000,31770413,31770413,4770413,1990
1999-07-16,3841,The Wood,6000000,25059640,25059640,19059640,1990
1999-07-16,4227,The Velocity of Gary,4000000,34145,34145,-3965855,1990
1999-07-23,514,The Haunting,80000000,180188905,91188905,100188905,1990
1999-07-23,588,Inspector Gadget,75000000,97387965,97387965,22387965,1990
1999-07-23,3386,Drop Dead Gorgeous,10000000,10571408,10571408,571408,1990
1999-07-28,807,Deep Blue Sea,60000000,165048228,73648228,105048228,1990
1999-07-30,639,Runaway Bride,70000000,310138178,152257509,240138178,1990
1999-07-30,5062,Twin Falls Idaho,500000,1027228,985341,527228,1990
1999-08-01,5204,Sticky Fingers of Time,250000,20628,18195,-229372,1990
1999-08-10,756,Random Hearts,64000000,63200000,31054924,-800000,1990
1999-08-10,2975,Superstar,14000000,30628981,30628981,16628981,1990
1999-08-10,3420,The Limey,10000000,6030047,3193102,-3969953,1990
1999-08-10,4553,Boys Don't Cry,2000000,20741000,11540607,18741000,1990
1999-08-10,5014,Naturally Native,700000,10508,10508,-689492,1990
1999-08-12,1688,Cradle Will Rock,32000000,2899970,2899970,-29100030,1990
1999-08-13,931,Bowfinger,55000000,98699769,66458769,43699769,1990
1999-08-13,2127,Brokedown Palace,25000000,11115766,10115014,-13884234,1990
1999-08-13,2764,Detroit Rock City,16000000,5825314,4217115,-10174686,1990
1999-08-20,1363,Mickey Blue Eyes,40000000,53864342,33864342,13864342,1990
1999-08-20,1410,Universal Soldier II: The Return,40000000,10717421,10447421,-29282579,1990
1999-08-25,3735,In Too Deep,7000000,15471229,14026509,8471229,1990
1999-08-27,252,The 13th Warrior,125000000,61698899,32698899,-63301101,1990
1999-08-27,1639,The Astronaut's Wife,34000000,10672566,10672566,-23327434,1990
1999-08-27,2268,Dudley Do-Right,22000000,9818792,9818792,-12181208,1990
1999-08-27,2884,The Muse,15000000,11614954,11614954,-3385046,1990
1999-08-27,3755,A Dog of Flanders,7000000,2165637,2165637,-4834363,1990
1999-08-27,3912,Stiff Upper Lips,5700000,69582,69582,-5630418,1990
1999-09-04,3807,Go!,6500000,28383441,16875273,21883441,1990
1999-09-04,4694,Foolish,1600000,6026908,6026908,4426908,1990
1999-09-07,2281,Arlington Road,21500000,24419219,24419219,2919219,1990
1999-09-07,3123,American Pie,12000000,234723148,101800948,222723148,1990
1999-09-15,2793,American Beauty,15000000,356258047,130058047,341258047,1990
1999-09-17,1071,For Love of the Game,50000000,46112640,35188640,-3887360,1990
1999-09-17,1492,Blue Streak,36000000,117448157,68208190,81448157,1990
1999-09-17,3218,Breakfast of Champions,12000000,178287,178287,-11821713,1990
1999-09-17,4293,Taxman,3500000,9871,9871,-3490129,1990
1999-09-17,5197,Sugar Town,250000,178095,178095,-71905,1990
1999-09-24,1286,Double Jeopardy,40000000,177835231,116735231,137835231,1990
1999-09-24,1879,Mumford,28700000,4559569,4559569,-24140431,1990
1999-09-24,2645,One Man's Hero,18000000,229311,229311,-17770689,1990
1999-09-24,2910,Jakob the Liar,15000000,4956401,4956401,-10043599,1990
1999-10-06,1511,Austin Powers: The Spy Who Shagged Me,35000000,310332636,206040085,275332636,1990
1999-10-09,1670,Stigmata,32000000,89441732,50041732,57441732,1990
1999-10-09,3163,A Stir of Echoes,12000000,21133087,21133087,9133087,1990
1999-10-09,4202,Love Stinks,4000000,2793776,2793776,-1206224,1990
1999-10-11,1725,Pokemon: The First Movie,30000000,163644662,85744662,133644662,1990
1999-10-11,3073,Light It Up,13000000,5871603,5871603,-7128397,1990
1999-10-12,778,The Green Mile,60000000,290701374,136801374,230701374,1990
1999-10-12,2572,Deuce Bigalow: Male Gigolo,18000000,92935067,65535067,74935067,1990
1999-10-12,3233,Diamonds,11900000,81897,81897,-11818103,1990
1999-10-15,740,Fight Club,65000000,100851897,37030102,35851897,1990
1999-10-15,1082,The Story of Us,50000000,27100030,27100030,-22899970,1990
1999-10-15,3406,The Straight Story,10000000,6197866,6197866,-3802134,1990
1999-10-15,3706,The Omega Code,7200000,12678312,12610552,5478312,1990
1999-10-22,1683,Bringing Out The Dead,32000000,16640210,16640210,-15359790,1990
1999-10-22,2302,Molly,21000000,17396,17396,-20982604,1990
1999-10-22,2450,Three to Tango,20000000,10570375,10570375,-9429625,1990
1999-10-22,2920,Crazy in Alabama,15000000,1954202,1954202,-13045798,1990
1999-10-22,3518,The Best Man,9000000,34572780,34102780,25572780,1990
1999-10-22,3810,Bats,6500000,10155691,10155691,3655691,1990
1999-10-22,5056,Beyond the Mat,500000,2047570,2047570,1547570,1990
1999-10-29,2487,Mononoke-hime,20000000,150350000,2374107,130350000,1990
1999-10-29,2538,House on Haunted Hill,19000000,65090541,40846082,46090541,1990
1999-10-29,3058,Being John Malkovich,13000000,32382381,22858926,19382381,1990
1999-10-29,4320,Dreaming of Joseph Lees,3250000,7680,7680,-3242320,1990
1999-11-06,3388,Le Violon rouge,10000000,10019109,10019109,19109,1990
1999-11-19,202,The World is Not Enough,135000000,361730660,126930660,226730660,1990
1999-11-19,396,Toy Story 2,90000000,511358276,245852179,421358276,1990
1999-11-19,646,Sleepy Hollow,70000000,207068340,101068340,137068340,1990
1999-11-24,348,End of Days,100000000,212026975,66889043,112026975,1990
1999-11-24,1626,Ride With the Devil,35000000,630779,630779,-34369221,1990
1999-11-24,1960,Flawless,27000000,4485485,4485485,-22514515,1990
1999-11-24,5156,Tumbleweeds,312000,1788168,1350248,1476168,1990
1999-12-02,844,My Favorite Martian,60000000,36850101,36850101,-23149899,1990
1999-12-02,1575,Blast from the Past,35000000,26613620,26613620,-8386380,1990
1999-12-02,1756,Message in a Bottle,30000000,52880016,52880016,22880016,1990
1999-12-02,4124,Tango,4500000,5428387,1687311,928387,1990
1999-12-03,1405,The Deep End of the Ocean,40000000,13508635,13508635,-26491365,1990
1999-12-03,1831,Wing Commander,30000000,11578022,11578022,-18421978,1990
1999-12-03,2296,The Rage: Carrie 2,21000000,17760244,17760244,-3239756,1990
1999-12-03,3051,Baby Geniuses,13000000,27151490,27151490,14151490,1990
1999-12-03,3375,The Corruptor,10000000,15164492,15164492,5164492,1990
1999-12-05,4360,Trippin',3000000,9017070,9017070,6017070,1990
1999-12-11,1103,The Messenger: The Story of Joan of Arc,50000000,14271297,14271297,-35728703,1990
1999-12-11,2210,Anywhere But Here,23000000,18653615,18653615,-4346385,1990
1999-12-11,2924,Felicia's Journey,15000000,1970268,824295,-13029732,1990
1999-12-11,3337,Dogma,10000000,43948865,30651422,33948865,1990
1999-12-17,313,Stuart Little,105000000,298815224,140015224,193815224,1990
1999-12-17,425,Bicentennial Man,90000000,87420776,58220776,-2579224,1990
1999-12-17,604,Anna and the King,75000000,39251128,39251128,-35748872,1990
1999-12-17,1487,Magnolia,37000000,48446802,22450975,11446802,1990
1999-12-17,2472,Topsy Turvy,20000000,6201757,6201757,-13798243,1990
1999-12-21,2180,"Girl, Interrupted",24000000,28871190,28871190,4871190,1990
1999-12-22,803,Any Given Sunday,60000000,100230832,75530832,40230832,1990
1999-12-22,994,Man on the Moon,52000000,47407635,34580635,-4592365,1990
1999-12-24,1175,Galaxy Quest,45000000,90523726,71423726,45523726,1990
1999-12-24,1306,The Talented Mr. Ripley,40000000,128792135,81292135,88792135,1990
1999-12-24,1500,Snow Falling on Cedars,36000000,14378353,14378353,-21621647,1990
1999-12-24,2114,Angela's Ashes,25000000,13038660,13038660,-11961340,1990
1999-12-24,2189,Play it to the Bone,24000000,8427204,8427204,-15572796,1990
1999-12-24,5354,Pink Narcissus,27000,8231,8231,-18769,1990
1999-12-29,1455,The Hurricane,38000000,73956241,50699241,35956241,1990
2000-01-01,528,Fantasia 2000 (IMAX),80000000,60507228,60507228,-19492772,2000
2000-01-03,4186,3 Strikes,4000000,9821335,9821335,5821335,2000
2000-01-09,2879,Highlander: Endgame,15000000,12801190,12801190,-2198810,2000
2000-01-09,4375,Whipped,3000000,4142507,4142507,1142507,2000
2000-01-12,4880,Panic,1000000,1425707,779137,425707,2000
2000-01-14,868,Supernova,60000000,14816494,14218868,-45183506,2000
2000-01-14,5358,The Terrorist,25000,195043,195043,170043,2000
2000-01-21,3522,Down to You,9000000,20035310,20035310,11035310,2000
2000-01-21,3777,The Boondock Saints,7000000,411874,30471,-6588126,2000
2000-01-28,1503,Isn't She Great,36000000,2954405,2954405,-33045595,2000
2000-01-28,2869,Eye of the Beholder,15000000,18260865,16500786,3260865,2000
2000-01-28,4219,The Big Tease,4000000,185577,185577,-3814423,2000
2000-02-06,1644,Big Momma's House,33000000,173559438,117559438,140559438,2000
2000-02-18,1361,Hanging Up,40000000,51867723,36037909,11867723,2000
2000-02-18,2169,The Whole Nine Yards,24000000,85527867,57262492,61527867,2000
2000-02-18,2204,Pitch Black,23000000,53182088,39235088,30182088,2000
2000-02-18,3525,Boiler Room,9000000,28773637,16963963,19773637,2000
2000-02-23,1589,Wonder Boys,35000000,33422485,19389454,-1577515,2000
2000-02-25,1499,Reindeer Games,36000000,23360779,23360779,-12639221,2000
2000-03-03,1114,What Planet Are You From?,50000000,6291602,6291602,-43708398,2000
2000-03-03,2106,The Next Best Thing,25000000,24355762,14983572,-644238,2000
2000-03-03,2750,Drowning Mona,16000000,15980376,15427192,-19624,2000
2000-03-03,4574,Ghost Dog: The Way of the Samurai,2000000,10672492,3330230,8672492,2000
2000-03-11,403,Charlie's Angels,90000000,259736090,125305545,169736090,2000
2000-03-11,854,The Legend of Bagger Vance,60000000,39235486,30695227,-20764514,2000
2000-03-17,1015,Erin Brockovich,50000000,257805243,125548685,207805243,2000
2000-03-17,2201,Final Destination,23000000,112036870,53302314,89036870,2000
2000-03-22,2035,Romeo Must Die,25000000,91036760,55973336,66036760,2000
2000-03-24,2888,Here on Earth,15000000,10845127,10494147,-4154873,2000
2000-03-24,2897,Whatever it Takes,15000000,8735529,8735529,-6264471,2000
2000-03-31,378,The Road to El Dorado,95000000,65700000,50802661,-29300000,2000
2000-03-31,2382,High Fidelity,20000000,47881663,27277055,27881663,2000
2000-03-31,2830,The Skulls,15000000,35007180,35007180,20007180,2000
2000-04-02,1299,Scream 3,40000000,161838076,89138076,121838076,2000
2000-04-02,3432,Gun Shy,10000000,1638202,1638202,-8361798,2000
2000-04-08,417,Hollow Man,90000000,191200000,73209340,101200000,2000
2000-04-08,722,Space Cowboys,65000000,128874043,90454043,63874043,2000
2000-04-08,1183,Coyote Ugly,45000000,113916474,60786269,68916474,2000
2000-04-08,4180,Saving Grace,4000000,27786849,12178602,23786849,2000
2000-04-08,4218,Psycho Beach Party,4000000,267972,267972,-3732028,2000
2000-04-14,1241,28 Days,43000000,62063972,37035515,19063972,2000
2000-04-14,1869,Keeping the Faith,29000000,45336404,37036404,16336404,2000
2000-04-14,3624,American Psycho,8000000,28674417,15070285,20674417,2000
2000-04-14,4374,East is East,3000000,30438635,4170647,27438635,2000
2000-04-19,4285,La otra conquista,3500000,886410,886410,-2613590,2000
2000-04-21,763,U-571,62000000,127630030,77086030,65630030,2000
2000-04-21,2848,Love and Basketball,15000000,27709625,27441122,12709625,2000
2000-04-21,3000,Gossip,14000000,12591270,5108820,-1408730,2000
2000-04-21,3865,The Virgin Suicides,6000000,10619770,4859475,4619770,2000
2000-04-28,889,The Flintstones in Viva Rock Vegas,58000000,59431365,35231365,1431365,2000
2000-04-28,1700,Frequency,31000000,68079671,44983704,37079671,2000
2000-04-28,2834,Where the Heart Is,15000000,40862054,33771174,25862054,2000
2000-05-04,3412,Black and White,10000000,5241315,5241315,-4758685,2000
2000-05-05,319,Gladiator,103000000,457683805,187683805,354683805,2000
2000-05-05,1640,I Dreamed of Africa,34000000,14291999,6543194,-19708001,2000
2000-05-05,3728,Michael Jordan to the MAX,7000000,18642318,18642318,11642318,2000
2000-05-05,4314,Human Traffic,3300000,5422740,104257,2122740,2000
2000-05-05,4773,The Basket,1300000,609042,609042,-690958,2000
2000-05-05,4892,Luminarias,1000000,428535,428535,-571465,2000
2000-05-19,228,Dinosaur,127500000,356148063,137748063,228648063,2000
2000-05-19,2606,Small Time Crooks,18000000,29934477,17266359,11934477,2000
2000-05-19,2727,Road Trip,16000000,119739110,68525609,103739110,2000
2000-05-24,254,Mission: Impossible 2,120000000,549588516,215409889,429588516,2000
2000-05-26,935,Shanghai Noon,55000000,71189835,56932305,16189835,2000
2000-05-26,4599,Hum to Mohabbt Karega,2000000,121807,121807,-1878193,2000
2000-06-10,909,Meet the Parents,55000000,304599899,166225040,249599899,2000
2000-06-10,1397,Get Carter,40000000,19417182,14967182,-20582818,2000
2000-06-10,3426,Bamboozled,10000000,2373937,2185266,-7626063,2000
2000-06-10,4022,Digimon: The Movie,5000000,16628751,9628751,11628751,2000
2000-06-10,4121,Requiem for a Dream,4500000,7389233,3635482,2889233,2000
2000-06-16,554,Fantasia 2000 (Theatrical Release),80000000,9103630,9103630,-70896370,2000
2000-06-16,610,Titan A.E.,75000000,36751979,22751979,-38248021,2000
2000-06-16,976,Shaft,53012938,107190108,70327868,54177170,2000
2000-06-16,2745,Boys and Girls,16000000,21799652,21799652,5799652,2000
2000-06-16,4485,Jesus' Son,2500000,1687548,1282084,-812452,2000
2000-06-21,1249,Chicken Run,42000000,227793915,106793915,185793915,2000
2000-06-23,997,"Me, Myself & Irene",51000000,149270999,90570999,98270999,2000
2000-06-23,5273,Woman Chaser,150000,110719,110719,-39281,2000
2000-06-28,291,The Patriot,110000000,215300000,113330342,105300000,2000
2000-06-30,255,The Perfect Storm,120000000,328711434,182618434,208711434,2000
2000-06-30,571,The Adventures of Rocky & Bullwinkle,76000000,35129610,26000610,-40870390,2000
2000-07-04,812,Rules of Engagement,60000000,71719931,61322858,11719931,2000
2000-07-04,2176,Return to Me,24000000,32662299,32662299,8662299,2000
2000-07-04,2187,Ready to Rumble,24000000,12372410,12372410,-11627590,2000
2000-07-07,728,The Kid,65000000,69688384,69688384,4688384,2000
2000-07-07,2529,Scary Movie,19000000,277200000,157019771,258200000,2000
2000-07-07,4803,But I'm a Cheerleader,1200000,2509344,2205627,1309344,2000
2000-07-14,581,X-Men,75000000,296339717,157299717,221339717,2000
2000-07-14,5191,Chuck&Buck,250000,1157672,1055671,907672,2000
2000-07-19,2908,The In Crowd,15000000,5217498,5217498,-9782502,2000
2000-07-21,400,What Lies Beneath,90000000,288693989,155464351,198693989,2000
2000-07-21,1767,Pokemon 2000,30000000,133946923,43746923,103946923,2000
2000-07-21,2426,Loser,20000000,18250106,15464026,-1749894,2000
2000-07-26,2545,Thomas and the Magic Railroad,19000000,15911332,15911332,-3088668,2000
2000-07-28,476,Nutty Professor II: The Klumps,84000000,166307945,123307945,82307945,2000
2000-08-09,1650,The Watcher,33000000,47267829,28946615,14267829,2000
2000-08-09,2181,Nurse Betty,24000000,27732366,25170054,3732366,2000
2000-08-09,3535,The Way of the Gun,9000000,13061935,6047856,4061935,2000
2000-08-09,4499,Anatomie,2500000,9598,9598,-2490402,2000
2000-08-09,4882,Fiza,1000000,1179462,623791,179462,2000
2000-08-12,593,Vertical Limit,75000000,213500000,68473360,138500000,2000
2000-08-12,743,Proof of Life,65000000,62761005,32598931,-2238995,2000
2000-08-12,1597,Dungeons and Dragons,35000000,33771965,15185241,-1228035,2000
2000-08-12,2794,"Crouching Tiger, Hidden Dragon",15000000,213514672,128067808,198514672,2000
2000-08-12,3339,Snatch,10000000,83593107,30093107,73593107,2000
2000-08-18,1533,The Cell,35000000,85911226,61280963,50911226,2000
2000-08-18,4336,The Original Kings of Comedy,3000000,38236338,38168022,35236338,2000
2000-08-18,4852,Godzilla 2000,1000000,10037390,10037390,9037390,2000
2000-08-25,1372,The Art of War,40000000,30199105,30199105,-9800895,2000
2000-08-25,2214,The Crew,23000000,13019253,13019253,-9980747,2000
2000-08-25,3309,Bring it On,10000000,90453550,68353550,80453550,2000
2000-08-25,5342,Smiling Fish and Goat on Fire,40000,277233,277233,237233,2000
2000-09-06,318,Gone in 60 Seconds,103300000,232643008,101643008,129343008,2000
2000-09-06,5060,Groove,500000,1167524,1115313,667524,2000
2000-09-15,850,Almost Famous,60000000,47371191,32522352,-12628809,2000
2000-09-15,1596,Bait,35000000,15471969,15325127,-19528031,2000
2000-09-15,2763,Duets,16000000,6615452,4734235,-9384548,2000
2000-09-15,5226,Urbania,225000,1032075,1032075,807075,2000
2000-09-22,2857,Urban Legends: Final Cut,15000000,38574362,21468807,23574362,2000
2000-09-22,3110,Dancer in the Dark,12500000,45557491,4157491,33057491,2000
2000-09-22,3635,Woman on Top,8000000,10192613,5018450,2192613,2000
2000-09-22,4913,The Specials,1000000,12996,12996,-987004,2000
2000-09-27,3846,Best in Show,6000000,20695413,18621249,14695413,2000
2000-09-29,1713,Remember the Titans,30000000,136706683,115654751,106706683,2000
2000-09-29,3540,Beautiful,9000000,3134509,3134509,-5865491,2000
2000-09-29,4872,The Broken Hearts Club: A Romantic Comedy,1000000,2022442,1744858,1022442,2000
2000-10-03,424,Mission to Mars,90000000,106000000,60874615,16000000,2000
2000-10-03,1464,The Ninth Gate,38000000,58394308,18653746,20394308,2000
2000-10-03,4986,Deterrence,800000,371647,144583,-428353,2000
2000-10-03,5158,God's Army,300000,2652515,2637726,2352515,2000
2000-10-11,533,Little Nicky,80000000,58270391,39442871,-21729609,2000
2000-10-11,551,Red Planet,80000000,33463969,17480890,-46536031,2000
2000-10-11,1671,Men of Honor,32000000,82339483,48814909,50339483,2000
2000-10-11,4796,You Can Count on Me,1200000,10827356,9180275,9627356,2000
2000-10-13,1917,Lost Souls,28000000,31320293,16779636,3320293,2000
2000-10-13,3264,The Ladies Man,11000000,13719474,13592872,2719474,2000
2000-10-13,3524,The Contender,9000000,17804273,17804273,8804273,2000
2000-10-13,3983,Billy Elliot,5000000,109273197,21995263,104273197,2000
2000-10-13,4410,Just Looking,3000000,39852,39852,-2960148,2000
2000-10-20,1137,Bedazzled,48000000,90376224,37879996,42376224,2000
2000-10-20,1364,Pay it Forward,40000000,55696705,33508922,15696705,2000
2000-10-20,2497,The Yards,20000000,2282710,882710,-17717290,2000
2000-10-20,4552,The Legend of Drunken Master,2000000,11546543,11546543,9546543,2000
2000-10-27,752,Lucky Numbers,65000000,10014234,10014234,-54985766,2000
2000-10-27,2264,The Little Vampire,22000000,13555988,13555988,-8444012,2000
2000-10-27,2849,Book of Shadows: Blair Witch 2,15000000,47721314,26421314,32721314,2000
2000-10-27,3948,A Room for Romeo Brass,5250000,20097,20097,-5229903,2000
2000-10-27,5340,George Washington,42000,342722,241816,300722,2000
2000-10-31,5030,Mercy Streets,600000,173599,173599,-426401,2000
2000-11-02,1065,The Beach,50000000,39778599,39778599,-10221401,2000
2000-11-02,2346,The Tigger Movie,20000000,96147688,45542421,76147688,2000
2000-11-02,3036,Snow Day,13000000,62452927,60008303,49452927,2000
2000-11-02,5235,Trois,200000,1161843,1161843,961843,2000
2000-11-08,1057,The Replacements,50000000,50054511,44737059,54511,2000
2000-11-08,1356,Autumn in New York,40000000,90717684,37752931,50717684,2000
2000-11-08,1374,Bless the Child,40000000,40435694,29374178,435694,2000
2000-11-08,3437,Cecil B. Demented,10000000,1953882,1276984,-8046118,2000
2000-11-08,3793,Aimée & Jaguar,6800000,927107,927107,-5872893,2000
2000-11-17,253,How the Grinch Stole Christmas,123000000,345141403,260044825,222141403,2000
2000-11-17,484,The 6th Day,82000000,96024898,34543701,14024898,2000
2000-11-17,1557,Bounce,35000000,53425292,36805288,18425292,2000
2000-11-17,1731,Rugrats in Paris,30000000,103284813,76501438,73284813,2000
2000-11-22,456,102 Dalmatians,85000000,66941559,66941559,-18058441,2000
2000-11-22,617,Unbreakable,73243106,248099143,94999143,174856037,2000
2000-11-22,3023,Quills,13500000,11732088,7060876,-1767912,2000
2000-12-01,3495,Next Friday,9500000,59675307,57176582,50175307,2000
2000-12-01,3715,My Dog Skip,7000000,35795319,34099640,28795319,2000
2000-12-05,544,Battlefield Earth: A Saga of the Year 3000,80000000,29725663,21471685,-50274337,2000
2000-12-05,2607,Center Stage,18000000,21361109,17200925,3361109,2000
2000-12-05,3186,Screwed,12000000,6982680,6982680,-5017320,2000
2000-12-05,3636,Held Up,8000000,4714090,4714090,-3285910,2000
2000-12-05,4582,Hamlet,2000000,2419669,1577287,419669,2000
2000-12-15,342,The Emperor's New Groove,100000000,169296573,89296573,69296573,2000
2000-12-15,707,What Women Want,65000000,374105123,182805123,309105123,2000
2000-12-15,2029,Chocolat,25000000,152500343,71309760,127500343,2000
2000-12-15,3044,"Dude, Where's My Car?",13000000,73180297,46729374,60180297,2000
2000-12-15,3859,Pollock,6000000,10557291,8596914,4557291,2000
2000-12-19,1240,Finding Forrester,43000000,80013623,51768623,37013623,2000
2000-12-19,3382,The Gift,10000000,44567606,12008642,34567606,2000
2000-12-22,439,Cast Away,85000000,427230516,233632142,342230516,2000
2000-12-22,540,Thirteen Days,80000000,66554547,34566746,-13445453,2000
2000-12-22,801,The Family Man,60000000,124715863,75764085,64715863,2000
2000-12-22,1164,Miss Congeniality,45000000,213420951,106807667,168420951,2000
2000-12-22,1217,All the Pretty Horses,45000000,18120267,15527125,-26879733,2000
2000-12-22,1907,Dracula 2000,28000000,33000377,33000377,5000377,2000
2000-12-22,1981,"O Brother, Where Art Thou?",26000000,75763814,45506619,49763814,2000
2000-12-22,3422,The House of Mirth,10000000,5149131,3041803,-4850869,2000
2000-12-22,4225,An Everlasting Piece,4000000,75078,75078,-3924922,2000
2000-12-27,1126,Traffic,48000000,208300000,124107476,160300000,2000
2000-12-29,3089,The Claim,13000000,1375635,622023,-11624365,2000
2000-12-29,3631,Shadow of the Vampire,8000000,8279017,8279017,279017,2000
2001-01-06,1791,What's the Worst That Could Happen?,30000000,38462071,32267774,8462071,2000
2001-01-06,2238,The Animal,22000000,55762229,55762229,33762229,2000
2001-01-19,1212,The Pledge,45000000,29406132,19719930,-15593868,2000
2001-01-26,1894,The Wedding Planner,28000000,94728529,60400856,66728529,2000
2001-02-02,2563,Left Behind,18500000,4221341,4221341,-14278659,2000
2001-02-02,2995,Head Over Heels,14000000,10397365,10397365,-3602635,2000
2001-02-02,3358,Valentine,10000000,20384136,20384136,10384136,2000
2001-02-03,1318,The Mexican,40000000,145238250,66808615,105238250,2000
2001-02-03,2738,See Spot Run,16000000,43057552,33357476,27057552,2000
2001-02-03,3026,The Caveman's Valentine,13500000,892506,687081,-12607494,2000
2001-02-03,3079,The Widow of St. Pierre,13000000,3058380,3058380,-9941620,2000
2001-02-11,275,"Monsters, Inc.",115000000,559757719,289423425,444757719,2000
2001-02-11,982,Domestic Disturbance,53000000,54207112,45207112,1207112,2000
2001-02-11,1120,The One,49000000,72689126,43905746,23689126,2000
2001-02-11,3299,Le Fabuleux destin d'Amélie Poulain,10350000,174201661,33201661,163851661,2000
2001-02-11,5087,Everything Put Together,500000,7890,0,-492110,2000
2001-02-16,1381,Sweet November,40000000,65754228,25288103,25754228,2000
2001-02-16,1739,Down to Earth,30000000,71172251,64172251,41172251,2000
2001-02-16,3324,Recess: School's Out,10000000,44451470,36696761,34451470,2000
2001-02-23,614,Monkeybone,75000000,5409517,5409517,-69590483,2000
2001-02-23,767,3000 Miles to Graceland,62000000,18708848,15738632,-43291152,2000
2001-03-08,397,Rush Hour 2,90000000,347425832,226164286,257425832,2000
2001-03-08,1718,The Princess Diaries,30000000,165334774,108244774,135334774,2000
2001-03-08,1990,Original Sin,26000000,16521410,16521410,-9478590,2000
2001-03-16,461,Enemy at the Gates,85000000,96971293,51396781,11971293,2000
2001-03-16,1645,Exit Wounds,33000000,79958599,51758599,46958599,2000
2001-03-16,3979,Memento,5000000,39723096,25544867,34723096,2000
2001-03-16,5192,American Desi,250000,1366235,902835,1116235,2000
2001-03-16,5330,Gabriela,50000,2335352,2335352,2285352,2000
2001-03-23,1457,Heartbreakers,38000000,57753825,40334024,19753825,2000
2001-03-23,2135,Say It Isn't So,25000000,5516708,5516708,-19483292,2000
2001-03-23,3837,The Brothers,6000000,27958191,27457409,21958191,2000
2001-03-30,1518,Spy Kids,35000000,197692062,112692062,162692062,2000
2001-03-30,2205,Someone Like You,23000000,38684906,27338033,15684906,2000
2001-03-30,2616,Tailor of Panama,18000000,27491653,13491653,9491653,2000
2001-03-30,3265,Tomcats,11000000,13558739,13558739,2558739,2000
2001-03-30,4566,Amores Perros,2000000,20883834,5383834,18883834,2000
2001-04-05,368,The Mummy Returns,98000000,435040395,202007640,337040395,2000
2001-04-05,4605,Eureka,2000000,76654,49388,-1923346,2000
2001-04-07,790,Cats & Dogs,60000000,200700000,93375151,140700000,2000
2001-04-07,1176,Scary Movie 2,45000000,141189101,71277420,96189101,2000
2001-04-13,2028,Bridget Jones's Diary,25000000,281527158,71500556,256527158,2000
2001-04-20,2082,Crocodile Dundee in Los Angeles,25000000,39393111,25590119,14393111,2000
2001-04-20,2873,Freddy Got Fingered,15000000,14249005,14249005,-750995,2000
2001-04-27,317,Town & Country,105000000,10364769,6712451,-94635231,2000
2001-04-27,629,Driven,72000000,54616869,32616869,-17383131,2000
2001-04-27,3664,Akira,8000000,19585,19585,-7980415,2000
2001-04-27,4027,The Forsaken,5000000,6755271,6755271,1755271,2000
2001-05-10,1173,Training Day,45000000,104505362,76261036,59505362,2000
2001-05-10,1899,Serendipity,28000000,77477297,50255310,49477297,2000
2001-05-10,2207,Joy Ride,23000000,21973182,21973182,-1026818,2000
2001-05-10,3170,Max Keeble's Big Move,12000000,17292381,17292381,5292381,2000
2001-05-18,981,Moulin Rouge,53000000,179209685,57386369,126209685,2000
2001-05-18,1002,Shrek,50000000,491812794,267655011,441812794,2000
2001-05-18,1462,Angel Eyes,38000000,29544532,24044532,-8455468,2000
2001-05-25,132,Pearl Harbor,151500000,449239855,198539855,297739855,2000
2001-06-04,1419,Just Visiting,40000000,16172200,4777007,-23827800,2000
2001-06-04,1755,Blow,30000000,83282296,52990775,53282296,2000
2001-06-04,1886,Along Came a Spider,28000000,105159085,74058698,77159085,2000
2001-06-04,4350,Pokemon 3: The Movie,3000000,68452128,17052128,65452128,2000
2001-06-04,4879,Brigham City,1000000,852206,852206,-147794,2000
2001-06-07,2060,Kiss of the Dragon,25000000,36833473,36833473,11833473,2000
2001-06-07,5377,Cure,10000,94596,94596,84596,2000
2001-06-13,4151,Sexy Beast,4300000,10158355,6946056,5858355,2000
2001-06-15,385,Lara Croft: Tomb Raider,94000000,273330185,131144183,179330185,2000
2001-06-15,4669,Songcatcher,1800000,3050934,3050934,1250934,2000
2001-06-22,626,Doctor Dolittle 2,72000000,176101721,112950721,104101721,2000
2001-06-22,1444,The Fast and the Furious,38000000,206512310,144512310,168512310,2000
2001-06-27,2740,Baby Boy,16000000,28734552,28734552,12734552,2000
2001-06-29,415,Artificial Intelligence: AI,90000000,235900000,78616689,145900000,2000
2001-06-29,2948,Pandaemonium,15000000,0,0,-15000000,2000
2001-06-29,3063,crazy/beautiful,13000000,19929123,16929123,6929123,2000
2001-06-29,4284,Pootie Tang,3500000,3293258,3293258,-206742,2000
2001-07-09,1378,The Musketeer,40000000,27053815,27053815,-12946185,2000
2001-07-09,1466,Rock Star,38000000,19317765,16991902,-18682235,2000
2001-07-09,3005,Soul Survivors,14000000,4288246,3100650,-9711754,2000
2001-07-09,3059,Two Can Play That Game,13000000,22391450,22235901,9391450,2000
2001-07-09,5013,L.I.E.,700000,1140965,1140965,440965,2000
2001-07-12,441,Ocean's Eleven,85000000,450728529,183417150,365728529,2000
2001-07-12,3881,The Business of Strangers,6000000,1290920,1030920,-4709080,2000
2001-07-12,4877,No Man's Land,1000000,2684207,1067481,1684207,2000
2001-07-13,692,The Score,68000000,113542091,71069884,45542091,2000
2001-07-13,2568,Legally Blonde,18000000,141809235,96493426,123809235,2000
2001-07-13,4033,Made,5000000,5476060,5308707,476060,2000
2001-07-13,4534,Bully,2100000,1381824,881824,-718176,2000
2001-07-18,387,Jurassic Park III,93000000,365900000,181166115,272900000,2000
2001-07-20,1153,America's Sweethearts,46000000,160648493,93607673,114648493,2000
2001-07-20,3211,Brother,12000000,450594,450594,-11549406,2000
2001-07-20,3875,Hedwig and the Angry Inch,6000000,3747270,3067312,-2252730,2000
2001-07-20,3927,Ghost World,5500000,8761608,6217849,3261608,2000
2001-07-27,329,Planet of the Apes,100000000,362211740,180011740,262211740,2000
2001-07-27,5133,Jackpot,400000,44452,44452,-355548,2000
2001-08-06,412,Atlantis: The Lost Empire,90000000,186049020,84052762,96049020,2000
2001-08-06,523,Swordfish,80000000,147080413,69772969,67080413,2000
2001-08-06,535,Evolution,80000000,98341932,38311134,18341932,2000
2001-08-08,4362,The Deep End,3000000,9981635,8823109,6981635,2000
2001-08-10,2904,Mulholland Drive,15000000,11919578,7219578,-3080422,2000
2001-08-13,1135,K-PAX,48000000,50315140,50315140,2315140,2000
2001-08-17,901,Captain Corelli's Mandolin,57000000,62097495,25528495,5097495,2000
2001-08-17,1133,Rat Race,48000000,86607223,56607223,38607223,2000
2001-08-17,1601,American Outlaws,35000000,13601109,13264986,-21398891,2000
2001-08-17,3818,Aberdeen,6500000,64148,64148,-6435852,2000
2001-08-21,4765,Batman - The Movie,1377800,0,0,-1377800,2000
2001-08-22,4902,Lisa Picard is Famous,1000000,113433,113433,-886567,2000
2001-08-24,1922,John Carpenter's Ghosts of Mars,28000000,8434601,8434601,-19565399,2000
2001-08-24,1995,The Curse of the Jade Scorpion,26000000,18496522,7496522,-7503478,2000
2001-08-24,2249,Jay and Silent Bob Strike Back,22000000,33762400,30059386,11762400,2000
2001-08-24,2692,Summer Catch,17000000,19693891,19693891,2693891,2000
2001-08-24,3074,Bubble Boy,13000000,5002310,5002310,-7997690,2000
2001-08-31,3322,Jeepers Creepers,10000000,58939035,37904175,48939035,2000
2001-08-31,3997,O (Othello),5000000,16017403,16017403,11017403,2000
2001-08-31,4911,Speedway Junky,1000000,17127,17127,-982873,2000
2001-09-02,437,Hannibal,87000000,350100280,165092266,263100280,2000
2001-09-02,2257,Saving Silverman,22000000,25873142,19351569,3873142,2000
2001-09-03,1262,15 Minutes,42000000,56331864,24375436,14331864,2000
2001-09-03,3219,Company Man,12000000,622273,146028,-11377727,2000
2001-09-03,3384,Get Over It,10000000,19860259,11560259,9860259,2000
2001-09-03,5375,Dayereh,10000,673780,673780,663780,2000
2001-09-11,1314,Shallow Hal,40000000,70836296,70836296,30836296,2000
2001-09-11,1580,Heist,35000000,28906817,23483357,-6093183,2000
2001-09-11,5305,Keeping it Real: The Adventures of Greg Walloch,100000,1358,1358,-98642,2000
2001-09-14,2259,The Glass House,22000000,22861785,17951431,861785,2000
2001-09-14,2289,Hardball,21000000,43728560,40222729,22728560,2000
2001-09-21,2269,Megiddo: Omega Code 2,22000000,6047691,6047691,-15952309,2000
2001-09-21,3582,Glitter,8500000,4273372,4273372,-4226628,2000
2001-09-28,1044,Don’t Say a Word,50000000,104488383,54997476,54488383,2000
2001-09-28,1701,Hearts in Atlantis,31000000,30885781,24185781,-114219,2000
2001-09-28,1901,Zoolander,28000000,60780981,45172250,32780981,2000
2001-09-28,4589,Dinner Rush,2000000,1075504,638227,-924496,2000
2001-10-08,682,Osmosis Jones,70000000,13596911,13596911,-56403089,2000
2001-10-08,1708,American Pie 2,30000000,286500000,145096820,256500000,2000
2001-10-08,2666,The Others,17000000,207765056,96522687,190765056,2000
2001-10-08,4732,Session 9,1500000,1619602,378176,119602,2000
2001-10-19,866,The Last Castle,60000000,20541668,18208078,-39458332,2000
2001-10-19,1146,Riding in Cars with Boys,47000000,29781453,29781453,-17218547,2000
2001-10-19,1566,From Hell,35000000,68712365,31598308,33712365,2000
2001-10-24,3398,Bones,10000000,8378853,7316658,-1621147,2000
2001-10-26,2537,Thirteen Ghosts,19000000,68467960,41867960,49467960,2000
2001-10-26,2611,Life as a House,18000000,23889158,15652637,5889158,2000
2001-10-26,3414,On the Line,10000000,4690802,4365455,-5309198,2000
2001-10-26,3453,High Heels and Low Lifes,10000000,226792,226792,-9773208,2000
2001-10-26,4126,Donnie Darko,4500000,7503672,1472801,3003672,2000
2001-11-04,2262,Josie and the Pussycats,22000000,14252830,14252830,-7747170,2000
2001-11-04,2741,Joe Dirt,16000000,30987695,27087695,14987695,2000
2001-11-04,3725,Kingdom Come,7000000,23393939,23247539,16393939,2000
2001-11-05,1273,A Knight’s Tale,41000000,100622586,56083966,59622586,2000
2001-11-07,198,Final Fantasy: The Spirits Within,137000000,85131830,32131830,-51868170,2000
2001-11-14,4185,The Wash,4000000,10097096,10097096,6097096,2000
2001-11-16,233,Harry Potter and the Sorcerer’s Stone,125000000,974755371,317575550,849755371,2000
2001-11-16,3878,Novocaine,6000000,2522928,2025238,-3477072,2000
2001-11-21,422,Spy Game,90000000,143049560,62362560,53049560,2000
2001-11-21,1562,Black Knight,35000000,33422806,33422806,-1577194,2000
2001-11-21,3263,Out Cold,11000000,14786394,13906394,3786394,2000
2001-11-21,4870,The Sidewalks of New York,1000000,3575308,2402459,2575308,2000
2001-11-23,4684,In the Bedroom,1700000,42137871,35930604,40437871,2000
2001-11-30,1324,Behind Enemy Lines,40000000,58855732,58855732,18855732,2000
2001-11-30,1471,Texas Rangers,38000000,623374,623374,-37376626,2000
2001-12-01,1832,Antitrust,30000000,17865209,10965209,-12134791,2000
2001-12-01,2179,Double Take,24000000,29823162,29823162,5823162,2000
2001-12-01,3033,Save the Last Dance,13000000,122244329,91038276,109244329,2000
2001-12-10,603,Bandits,75000000,71523271,41523271,-3476729,2000
2001-12-10,3258,Corky Romano,11000000,25116103,23978402,14116103,2000
2001-12-14,647,Vanilla Sky,70000000,202726605,100614858,132726605,2000
2001-12-14,1897,The Royal Tenenbaums,28000000,71430876,52353636,43430876,2000
2001-12-14,2825,Not Another Teen Movie,15000000,62401343,37882551,47401343,2000
2001-12-14,3751,The Other Side of Heaven,7000000,4720371,4720371,-2279629,2000
2001-12-14,3928,Iris,5500000,15155021,5580479,9655021,2000
2001-12-19,308,The Lord of the Rings: The Fellowship of the Ring,109000000,887210985,315544750,778210985,2000
2001-12-21,560,A Beautiful Mind,78000000,317668058,170708996,239668058,2000
2001-12-21,630,The Majestic,72000000,37306334,27796042,-34693666,2000
2001-12-21,1463,Joe Somebody,38000000,24515990,22770864,-13484010,2000
2001-12-21,2021,Jimmy Neutron: Boy Genius,25000000,102992536,80936232,77992536,2000
2001-12-21,3150,How High,12000000,31222395,31155435,19222395,2000
2001-12-25,310,Ali,109000000,87683966,58183966,-21316034,2000
2001-12-25,1136,Kate and Leopold,48000000,70937778,47095453,22937778,2000
2001-12-25,1603,The Shipping News,35000000,24405825,11405825,-10594175,2000
2001-12-26,2587,Gosford Park,18000000,41300105,41300105,23300105,2000
2001-12-26,4169,Monster's Ball,4000000,43766463,31273922,39766463,2000
2001-12-28,372,Black Hawk Down,95000000,159691085,108638745,64691085,2000
2001-12-28,2244,I Am Sam,22000000,92542418,40270895,70542418,2000
2001-12-31,3695,The Hole,7500000,10834406,0,3334406,2000
2001-12-31,4638,Pendulum,2000000,0,0,-2000000,2000
2002-01-02,3075,Birthday Girl,13000000,8130727,4919896,-4869273,2000
2002-01-02,3271,Slackers,11000000,4814244,4814244,-6185756,2000
2002-01-02,5057,The Singles Ward,500000,1250798,1250798,750798,2000
2002-01-03,653,We Were Soldiers,70000000,114658262,78120196,44658262,2000
2002-01-03,2682,40 Days and 40 Nights,17000000,95092667,37939782,78092667,2000
2002-01-03,5269,The Calling,160000,32092,32092,-127908,2000
2002-01-11,671,I Spy,70000000,60279822,33561137,-9720178,2000
2002-01-11,713,The Santa Clause 2,65000000,172825854,139225854,107825854,2000
2002-01-18,1665,Snow Dogs,32000000,116898028,81150692,84898028,2000
2002-01-25,1259,The Mothman Prophecies,42000000,56438555,35228696,14438555,2000
2002-01-25,1332,The Count of Monte Cristo,40000000,75389090,54228104,35389090,2000
2002-01-25,2925,Metropolis,15000000,1405032,673414,-13594968,2000
2002-01-25,3250,A Walk to Remember,11000000,46060915,41227069,35060915,2000
2002-01-25,3371,Kung Pow: Enter the Fist,10000000,17033556,16033556,7033556,2000
2002-02-08,634,Signs,70702619,408269295,227969295,337566676,2000
2002-02-08,2733,The Master of Disguise,16000000,40363530,40363530,24363530,2000
2002-02-08,4346,Martin Lawrence Live: RunTelDat,3000000,19184820,19184820,16184820,2000
2002-02-08,4576,Full Frontal,2000000,3438804,2512846,1438804,2000
2002-02-15,678,Hart's War,70000000,33076815,19076815,-36923185,2000
2002-02-15,1491,John Q,36000000,102226631,71026631,66226631,2000
2002-02-15,2342,Peter Pan: Return to Neverland,20000000,109862682,48430258,89862682,2000
2002-02-15,3144,Crossroads,12000000,57000000,37188667,45000000,2000
2002-02-15,3199,Last Orders,12000000,2326407,2326407,-9673593,2000
2002-02-15,4794,Super Troopers,1200000,23046142,18492362,21846142,2000
2002-02-19,838,Reign of Fire,60000000,82150183,43061982,22150183,2000
2002-02-22,855,Dragonfly,60000000,30063805,30063805,-29936195,2000
2002-02-22,1568,Queen of the Damned,35000000,30307804,30307804,-4692196,2000
2002-02-22,4137,Mean Machine,4500000,92723,92723,-4407277,2000
2002-02-22,4795,Monsoon Wedding,1200000,27025600,13876974,25825600,2000
2002-02-22,4828,Sex with Strangers,1100000,247740,247740,-852260,2000
2002-03-05,193,Spider-Man,139000000,821706375,403706375,682706375,2000
2002-03-05,2762,Hollywood Ending,16000000,14839383,4839383,-1160617,2000
2002-03-05,3407,Deuces Wild,10000000,6244618,6044618,-3755382,2000
2002-03-07,183,Men in Black 2,140000000,441767803,190418803,301767803,2000
2002-03-07,1759,Like Mike,30000000,62432423,51432423,32432423,2000
2002-03-07,2119,The Powerpuff Girls,25000000,16425701,11411644,-8574299,2000
2002-03-13,4715,Kissing Jessica Stein,1500000,9345061,7025722,7845061,2000
2002-03-15,469,Showtime,85000000,78948765,37948765,-6051235,2000
2002-03-15,709,Ice Age,65000000,386116343,176387405,321116343,2000
2002-03-15,1550,Resident Evil,35000000,103787401,40119709,68787401,2000
2002-03-15,4005,Y Tu Mamá También,5000000,33649881,13649881,28649881,2000
2002-03-22,970,Blade 2,54000000,154338601,81676888,100338601,2000
2002-03-22,3182,Sorority Boys,12000000,12516222,10198766,516222,2000
2002-03-22,4740,Stolen Summer,1500000,119841,119841,-1380159,2000
2002-03-29,1111,Death to Smoochy,50000000,8374062,8355815,-41625938,2000
2002-03-29,1127,Panic Room,48000000,196308367,95308367,148308367,2000
2002-03-29,1985,Clockstoppers,26000000,38788828,36985501,12788828,2000
2002-03-29,2235,The Rookie,22000000,80491516,75600072,58491516,2000
2002-04-01,1416,Impostor,40000000,7974607,6114237,-32025393,2000
2002-04-10,562,Red Dragon,78000000,206455420,92955420,128455420,2000
2002-04-10,2978,Jonah: A VeggieTales Movie,14000000,25608779,25571351,11608779,2000
2002-04-10,3212,Welcome to Collinwood,12000000,4606284,378650,-7393716,2000
2002-04-19,793,The Scorpion King,60000000,165890634,90580000,105890634,2000
2002-04-19,1076,Murder by Numbers,50000000,56643267,31874869,6643267,2000
2002-04-19,3953,My Big Fat Greek Wedding,5000000,374890034,241438208,369890034,2000
2002-04-19,4725,Nueve Reinas,1500000,12412889,1222889,10912889,2000
2002-04-26,1399,"Life, or Something Like It",40000000,14448589,14448589,-25551411,2000
2002-04-26,2643,The Salton Sea,18000000,676698,676698,-17323302,2000
2002-04-26,2990,Jason X,14000000,16951798,13121555,2951798,2000
2002-04-26,5127,Dogtown and Z-Boys,400000,1600566,1293295,1200566,2000
2002-05-04,1225,Big Trouble,45000000,8488871,7262288,-36511129,2000
2002-05-04,1256,High Crimes,42000000,63781100,41543207,21781100,2000
2002-05-04,3844,National Lampoon's Van Wilder,6000000,39241323,21305259,33241323,2000
2002-05-04,3893,Lucky Break,6000000,4316497,54606,-1683503,2000
2002-05-16,274,Star Wars Ep. II: Attack of the Clones,115000000,656695615,310676740,541695615,2000
2002-05-17,1945,About a Boy,27000000,130759651,40803000,103759651,2000
2002-05-17,3936,Harvard Man,5500000,56653,56653,-5443347,2000
2002-05-17,4730,The Believer,1500000,1840248,406035,340248,2000
2002-05-22,2899,The Importance of Being Earnest,15000000,8378141,8378141,-6621859,2000
2002-05-24,522,Spirit: Stallion of the Cimarron,80000000,106515310,73215310,26515310,2000
2002-05-24,1155,Insomnia,46000000,113622499,67263182,67622499,2000
2002-05-24,1458,Enough,38000000,50970660,39177215,12970660,2000
2002-05-24,4383,Thirteen Conversations About One Thing,3000000,3705923,3287435,705923,2000
2002-05-29,4535,Elling,2100000,313436,313436,-1786564,2000
2002-05-31,690,The Sum of All Fears,68000000,193500000,118471320,125500000,2000
2002-05-31,2058,Undercover Brother,25000000,40796145,38230435,15796145,2000
2002-06-09,1387,City by the Sea,40000000,22433915,22433915,-17566085,2000
2002-06-09,3345,Swimfan,10000000,34364995,28564995,24364995,2000
2002-06-11,1616,Femme Fatale,35000000,16830252,6630252,-18169748,2000
2002-06-12,851,Analyze That,60000000,54994757,32122249,-5005243,2000
2002-06-12,2493,Equilibrium,20000000,5345869,1190018,-14654131,2000
2002-06-12,2559,Adaptation,18500000,32531759,22498520,14031759,2000
2002-06-12,4270,Empire,3500000,18495444,17504595,14995444,2000
2002-06-14,279,Windtalkers,115000000,77628265,40914068,-37371735,2000
2002-06-14,475,Scooby-Doo,84000000,276294164,153294164,192294164,2000
2002-06-14,782,The Bourne Identity,60000000,214357371,121468960,154357371,2000
2002-06-14,3203,The Dangerous Lives of Altar Boys,12000000,1779284,1779284,-10220716,2000
2002-06-21,324,Minority Report,102000000,358824714,132024714,256824714,2000
2002-06-21,494,Lilo & Stitch,80000000,245800000,145771527,165800000,2000
2002-06-21,2779,Juwanna Mann,15600000,13771817,13571817,-1828183,2000
2002-06-21,3917,Sunshine State,5600000,3281898,3064356,-2318102,2000
2002-06-28,1014,Mr. Deeds,50000000,171269535,126293452,121269535,2000
2002-06-28,3379,Hey Arnold! The Movie,10000000,13684949,13684949,3684949,2000
2002-06-28,5187,Lovely and Amazing,250000,4613482,4210379,4363482,2000
2002-07-06,672,Bad Company,70000000,69157016,30157016,-842984,2000
2002-07-06,1939,The Divine Secrets of the Ya-Ya Sisterhood,27000000,73826768,69586544,46826768,2000
2002-07-08,1447,Spy Kids 2: The Island of Lost Dreams,38000000,119721296,85846296,81721296,2000
2002-07-08,3626,The Good Girl,8000000,16585503,14018296,8585503,2000
2002-07-17,1817,Eight Legged Freaks,30000000,36722311,17266505,6722311,2000
2002-07-19,264,Stuart Little 2,120000000,166000000,64956806,46000000,2000
2002-07-19,429,K-19: The Widowmaker,90000000,65716126,35168966,-24283874,2000
2002-07-19,5170,Ayurveda: Art of Being,300000,2066892,16892,1766892,2000
2002-07-19,5272,Tadpole,150000,3270128,2891288,3120128,2000
2002-07-25,759,Austin Powers in Goldmember,63000000,292738626,213117789,229738626,2000
2002-07-26,2419,The Country Bears,20000000,16988996,16988996,-3011004,2000
2002-08-02,468,Collateral Damage,85000000,78353508,40048332,-6646492,2000
2002-08-02,679,Rollerball,70000000,25852508,18990542,-44147492,2000
2002-08-02,2816,Big Fat Liar,15000000,52461017,47811275,37461017,2000
2002-08-03,529,The Time Machine,80000000,98983590,56684819,18983590,2000
2002-08-03,2979,All About the Benjamins,14000000,25873145,25482931,11873145,2000
2002-08-03,3687,Men with Brooms,7500000,4239767,4239767,-3260233,2000
2002-08-05,1046,Unfaithful,50000000,119114494,52752475,69114494,2000
2002-08-11,1272,8 Mile,41000000,245768384,116724075,204768384,2000
2002-08-11,3021,Far From Heaven,13500000,29027914,15901849,15527914,2000
2002-08-16,364,The Adventures of Pluto Nash,100000000,7094995,4411102,-92905005,2000
2002-08-16,1777,Blue Crush,30000000,51618420,40118420,21618420,2000
2002-08-16,2128,Possession,25000000,14805812,10103647,-10194188,2000
2002-08-21,3147,One Hour Photo,12000000,52223306,31597131,40223306,2000
2002-08-23,1874,Serving Sara,29000000,20146150,16930185,-8853850,2000
2002-08-23,2443,Undisputed,20000000,12398628,12398628,-7601372,2000
2002-08-23,5036,Crop Circles: Quest for Truth,600000,0,0,-600000,2000
2002-08-30,1407,FearDotCom,40000000,13208023,13208023,-26791977,2000
2002-09-08,640,xXx,70000000,267200000,141930000,197200000,2000
2002-09-08,1086,Blood Work,50000000,26199517,26199517,-23800483,2000
2002-09-08,4984,Pandora's Box,800000,881950,881950,81950,2000
2002-09-13,2111,Stealing Harvard,25000000,13973532,13973532,-11026468,2000
2002-09-13,3128,Barbershop,12000000,77063461,75781642,65063461,2000
2002-09-13,3537,Igby Goes Down,9000000,4777465,4777465,-4222535,2000
2002-09-13,3693,Betty Fisher et autres histoires,7500000,206400,206400,-7293600,2000
2002-09-20,681,Ballistic: Ecks vs. Sever,70000000,14294842,14294842,-55705158,2000
2002-09-20,968,Eye See You,55000000,1807990,79161,-53192010,2000
2002-09-20,1592,The Four Feathers,35000000,29882645,18306166,-5117355,2000
2002-09-20,1840,Trapped,30000000,6916869,6916869,-23083131,2000
2002-09-20,2547,Sen to Chihiro no Kamikakushi,19000000,274949886,10049886,255949886,2000
2002-09-20,3338,The Banger Sisters,10000000,38067218,30306281,28067218,2000
2002-09-20,3641,8 femmes,8000000,42376425,3076425,34376425,2000
2002-09-20,4198,Secretary,4000000,9413956,4046737,5413956,2000
2002-09-27,826,The Tuxedo,60000000,104429625,50586000,44429625,2000
2002-09-27,1445,Sweet Home Alabama,38000000,182365114,127214072,144365114,2000
2002-09-27,2299,Moonlight Mile,21000000,6830957,6830957,-14169043,2000
2002-09-27,2785,Wasabi,15300000,7000000,81525,-8300000,2000
2002-09-27,4952,Charly,950000,814666,814666,-135334,2000
2002-10-05,3049,The New Guy,13000000,28972187,28972187,15972187,2000
2002-10-05,5240,The Business of Fancy Dancing,200000,174682,174682,-25318,2000
2002-10-05,5241,Hybrid,200000,162605,162605,-37395,2000
2002-10-18,1125,The Ring,48000000,248218486,129094024,200218486,2000
2002-10-18,1959,Formula 51,27000000,5204007,5204007,-21795993,2000
2002-10-18,2125,Abandon,25000000,12219367,10719367,-12780633,2000
2002-10-18,3756,Auto Focus,7000000,2703821,2062066,-4296179,2000
2002-10-18,4369,Real Women Have Curves,3000000,7777790,5853194,4777790,2000
2002-10-25,2377,Ghost Ship,20000000,68349884,30113491,48349884,2000
2002-10-25,2938,All the Queen's Men,15000000,22723,22723,-14977277,2000
2002-10-25,3155,Frida,12000000,56131239,25885000,44131239,2000
2002-10-25,3551,All or Nothing,9000000,184255,184255,-8815745,2000
2002-10-25,3962,Jackass: The Movie,5000000,79282312,64282312,74282312,2000
2002-10-25,4977,Time Changer,825000,1500711,1500711,675711,2000
2002-11-01,2588,Orange County,18000000,43308707,41059716,25308707,2000
2002-11-10,2095,Punch-Drunk Love,25000000,24591031,17791031,-408969,2000
2002-11-10,2292,The Transporter,21000000,43928932,25296447,22928932,2000
2002-11-10,2748,White Oleander,16000000,21657770,16357770,5657770,2000
2002-11-10,2863,Tuck Everlasting,15000000,19344615,19161999,4344615,2000
2002-11-10,2883,Knockaround Guys,15000000,12419700,11660180,-2580300,2000
2002-11-10,3445,Swept Away,10000000,598645,598645,-9401355,2000
2002-11-10,3608,Brown Sugar,8000000,28315272,27362712,20315272,2000
2002-11-10,4194,The Rules of Attraction,4000000,11799060,6525762,7799060,2000
2002-11-10,4341,Bowling for Columbine,3000000,58240487,21576018,55240487,2000
2002-11-15,326,Harry Potter and the Chamber of Secrets,100000000,878979634,261987880,778979634,2000
2002-11-15,2101,Half Past Dead,25000000,19233280,15567860,-5766720,2000
2002-11-15,2781,Ararat,15500000,1693000,1693000,-13807000,2000
2002-11-15,4668,El crimen de padre Amaro,1800000,5719000,5719000,3919000,2000
2002-11-15,5001,Interview with the Assassin,750000,47329,47329,-702671,2000
2002-11-15,5149,Revolution#9,350000,9118,9118,-340882,2000
2002-11-22,180,Die Another Day,142000000,431942139,160942139,289942139,2000
2002-11-22,2439,The Quiet American,20000000,26348203,12987647,6348203,2000
2002-11-22,3100,The Emperor's Club,12500000,16193713,14060950,3693713,2000
2002-11-22,3331,Friday After Next,10000000,33526835,33253609,23526835,2000
2002-11-27,358,Treasure Planet,100000000,91800000,38120554,-8200000,2000
2002-11-27,1148,Solaris,47000000,14970038,14970038,-32029962,2000
2002-11-27,1418,Extreme Ops,40000000,12624471,4835968,-27375529,2000
2002-11-27,2695,Wes Craven Presents: They,17000000,16140842,12840842,-859158,2000
2002-11-29,3747,Rabbit-Proof Fence,7000000,16866928,6199600,9866928,2000
2002-12-04,1180,Changing Lanes,45000000,66790248,66790248,21790248,2000
2002-12-04,1243,The Sweetest Thing,43000000,63078756,24430272,20078756,2000
2002-12-04,3267,Frailty,11000000,19947280,13110448,8947280,2000
2002-12-07,505,Road to Perdition,80000000,183354514,104054514,103354514,2000
2002-12-07,2840,Halloween: Resurrection,15000000,37659652,30259652,22659652,2000
2002-12-07,3096,Crocodile Hunter: Collision Course,12500000,33436931,28436931,20936931,2000
2002-12-07,5066,Never Again,500000,308793,307631,-191207,2000
2002-12-13,837,Star Trek: Nemesis,60000000,67312826,43254409,7312826,2000
2002-12-13,921,Maid in Manhattan,55000000,163838217,93932896,108838217,2000
2002-12-13,1737,About Schmidt,30000000,107054484,65005217,77054484,2000
2002-12-13,2335,Drumline,20000000,56398162,56398162,36398162,2000
2002-12-13,4923,The Jimmy Show,1000000,703,703,-999297,2000
2002-12-18,384,The Lord of the Rings: The Two Towers,94000000,934699645,342548984,840699645,2000
2002-12-19,3098,Antwone Fisher,12500000,23367586,21078145,10867586,2000
2002-12-19,4118,25th Hour,4500000,25344490,13084595,20844490,2000
2002-12-20,369,Gangs of New York,97000000,183124621,77730500,86124621,2000
2002-12-20,791,Two Weeks Notice,60000000,199043309,93354918,139043309,2000
2002-12-20,2055,The Wild Thornberrys Movie,25000000,60694737,40108697,35694737,2000
2002-12-20,3684,Narc,7500000,11843260,10465659,4343260,2000
2002-12-20,3886,Morvern Callar,6000000,267194,267194,-5732806,2000
2002-12-25,987,Catch Me if You Can,52000000,355612291,164606800,303612291,2000
2002-12-25,1228,Pinocchio,45000000,31681811,3681811,-13318189,2000
2002-12-27,1564,The Pianist,35000000,111854182,32519322,76854182,2000
2002-12-27,1706,Chicago,30000000,306771047,170687518,276771047,2000
2002-12-27,2052,The Hours,25000000,97030468,41675994,72030468,2000
2002-12-27,3433,Nicholas Nickleby,10000000,1562800,1562800,-8437200,2000
2002-12-27,4230,Sonny,4000000,17639,17639,-3982361,2000
2002-12-30,4899,Love Lisa,1000000,213137,213137,-786863,2000
2002-12-31,1875,Confessions of a Dangerous Mind,29000000,33013805,16007718,4013805,2000
2003-01-07,103,Terminator 3: Rise of the Machines,170000000,433058296,150358296,263058296,2000
2003-01-08,917,American Wedding,55000000,126425115,104354205,71425115,2000
2003-01-08,975,Gigli,54000000,7126002,6087542,-46873998,2000
2003-01-17,809,Kangaroo Jack,60000000,90723216,66723216,30723216,2000
2003-01-17,2424,A Guy Thing,20000000,17430594,15543862,-2569406,2000
2003-01-17,4313,Cidade de Deus,3300000,32059295,7563397,28759295,2000
2003-01-24,3011,Amen,14000000,274299,274299,-13725701,2000
2003-01-24,3716,Darkness Falls,7000000,47289758,32539681,40289758,2000
2003-01-31,1980,Final Destination 2,26000000,90396664,46896664,64396664,2000
2003-01-31,3274,The Guru,11000000,24150550,3051221,13150550,2000
2003-01-31,5061,The R.M.,500000,1111615,1111615,611615,2000
2003-02-04,1845,The Good Thief,30000000,6460758,3517797,-23539242,2000
2003-02-05,237,X2,125000000,407711549,214949694,282711549,2000
2003-02-05,2820,The Lizzie McGuire Movie,15000000,55534455,42734455,40534455,2000
2003-02-05,3439,Owning Mahowny,10000000,1011054,1011054,-8988946,2000
2003-02-05,4890,Blue Car,1000000,475367,464126,-524633,2000
2003-02-07,860,Sinbad: Legend of the Seven Seas,60000000,80767884,26483452,20767884,2000
2003-02-07,2016,"Legally Blonde 2: Red, White & Blonde",25000000,125339088,90639088,100339088,2000
2003-02-14,507,Daredevil,80000000,182782518,102543518,102782518,2000
2003-02-14,2343,The Jungle Book 2,20000000,140122225,47901582,120122225,2000
2003-02-14,3772,Gerry,7000000,719699,254683,-6280301,2000
2003-02-14,4886,All the Real Girls,1000000,703020,549666,-296980,2000
2003-02-21,960,Gods and Generals,55000000,12923936,12882934,-42076064,2000
2003-02-21,1098,The Life of David Gale,50000000,28920188,19694635,-21079812,2000
2003-02-21,2166,Old School,24000000,86765463,75155000,62765463,2000
2003-02-21,2893,Dark Blue,15000000,12262065,9237470,-2737935,2000
2003-02-28,2066,Cradle 2 the Grave,25000000,56434942,34657731,31434942,2000
2003-02-28,3431,Spider,10000000,1641788,1641788,-8358212,2000
2003-02-28,4211,Poolhall Junkies,4000000,563711,563711,-3436289,2000
2003-03-10,1063,Out of Time,50000000,55489826,41083108,5489826,2000
2003-03-10,2323,School of Rock,20000000,131945303,81261177,111945303,2000
2003-03-10,3909,Foolproof,5800000,421021,230312,-5378979,2000
2003-03-10,3932,Wonderland,5500000,1060512,1060512,-4439488,2000
2003-03-10,4484,Sur Le Seuil,2500000,2013052,2013052,-486948,2000
2003-03-10,5053,The Station Agent,500000,9470209,5801558,8970209,2000
2003-03-10,5294,The Work and the Story,103000,16137,16137,-86863,2000
2003-03-14,949,The Hunted,55000000,47213095,34234008,-7786905,2000
2003-03-14,2044,Agent Cody Banks,25000000,58240458,47545060,33240458,2000
2003-03-14,2469,Willard,20000000,6882696,6882696,-13117304,2000
2003-03-14,4130,Spun,4500000,1022649,410241,-3477351,2000
2003-03-21,695,Dreamcatcher,68000000,75685268,33685268,7685268,2000
2003-03-21,2898,Boat Trip,15000000,14933713,8586376,-66287,2000
2003-03-21,3905,L'auberge espagnole,5900000,3895664,3895664,-2004336,2000
2003-03-21,4809,Down & Out with the Dolls,1200000,58936,58936,-1141064,2000
2003-03-28,473,The Core,85000000,74132631,31111260,-10867369,2000
2003-03-28,1084,Basic,50000000,42598498,26599248,-7401502,2000
2003-03-28,1507,Head of State,35200000,38283765,37788228,3083765,2000
2003-03-28,4982,Raising Victor Vargas,800000,2900578,2073984,2100578,2000
2003-04-03,4800,The Day the Earth Stood Still,1200000,3700000,3700000,2500000,2000
2003-04-04,1498,A Man Apart,36000000,43797731,26500000,7797731,2000
2003-04-04,2063,What a Girl Wants,25000000,35990505,35990505,10990505,2000
2003-04-04,3249,Phone Booth,11000000,97837138,46566212,86837138,2000
2003-04-04,4390,DysFunkTional Family,3000000,2255000,2255000,-745000,2000
2003-04-07,3674,Swimming Pool,7800000,24021282,10130108,16221282,2000
2003-04-16,996,Bulletproof Monk,52000000,23010607,23010607,-28989393,2000
2003-04-16,3534,Chasing Papi,9000000,12657377,6126237,3657377,2000
2003-04-16,3848,A Mighty Wind,6000000,18504539,17583468,12504539,2000
2003-04-18,1919,Winged Migration,28000000,39134983,11689053,11134983,2000
2003-04-18,2330,Holes,20000000,71232214,67383924,51232214,2000
2003-04-18,2832,Malibu's Most Wanted,15000000,34499204,34308901,19499204,2000
2003-04-18,4135,Lilja 4-ever,4500000,4556982,181655,56982,2000
2003-04-25,1898,Identity,28000000,82183683,52131264,54183683,2000
2003-04-25,2508,People I Know,20000000,5694213,121972,-14305787,2000
2003-04-25,2664,City of Ghosts,17500000,325491,325491,-17174509,2000
2003-04-25,2882,Confidence,15000000,12212417,12212417,-2787583,2000
2003-04-25,2931,Steal (Canadian Release),15000000,220944,220944,-14779056,2000
2003-04-25,4199,The Real Cancun,4000000,3816594,3816594,-183406,2000
2003-05-09,1613,The Order,35000000,11559747,7659747,-23440253,2000
2003-05-09,2690,Dickie Roberts: Former Child Star,17000000,23734486,22734486,6734486,2000
2003-05-11,154,The Matrix Revolutions,150000000,427300260,139270910,277300260,2000
2003-05-12,188,The Last Samurai,140000000,456810575,111110575,316810575,2000
2003-05-12,2591,Honey,18000000,62646763,30272254,44646763,2000
2003-05-14,4830,Dracula: Pages from a Virgin's Diary,1100000,81371,39659,-1018629,2000
2003-05-15,139,The Matrix Reloaded,150000000,738576929,281553689,588576929,2000
2003-05-23,485,Bruce Almighty,81000000,484468608,242704995,403468608,2000
2003-05-30,382,Finding Nemo,94000000,936429370,380529370,842429370,2000
2003-05-30,785,The Italian Job,60000000,176262839,106126012,116262839,2000
2003-05-30,3373,Wrong Turn,10000000,28649556,15417771,18649556,2000
2003-06-06,569,2 Fast 2 Furious,76000000,236410607,127120058,160410607,2000
2003-06-06,3931,Mambo Italiano,5500000,6148823,3031801,648823,2000
2003-06-06,4150,Whale Rider,4300000,39374600,20779666,35074600,2000
2003-06-08,1967,Freaky Friday,26000000,160822438,110222438,134822438,2000
2003-06-13,609,Hollywood Homicide,75000000,50409753,30207785,-24590247,2000
2003-06-13,1800,Dumb and Dumberer: When Harry Met Lloyd,30000000,26214846,26214846,-3785154,2000
2003-06-13,2056,Rugrats Go Wild,25000000,55443032,39402572,30443032,2000
2003-06-13,3774,The Heart of Me,7000000,196067,196067,-6803933,2000
2003-06-13,4064,Tycoon,5000000,121016,121016,-4878984,2000
2003-06-13,5360,Manito,25000,0,0,-25000,2000
2003-06-20,197,Hulk,137000000,245229234,132177234,108229234,2000
2003-06-20,1826,Alex & Emma,30000000,15358583,14208384,-14641417,2000
2003-06-20,3192,From Justin to Kelly,12000000,4922166,4922166,-7077834,2000
2003-06-20,3547,The Legend of Suriyothai,9000000,454255,454255,-8545745,2000
2003-06-27,260,Charlie's Angels: Full Throttle,120000000,227200000,100814328,107200000,2000
2003-06-27,3603,28 Days Later…,8000000,82955633,45064915,74955633,2000
2003-07-02,1016,How to Lose a Guy in 10 Days,50000000,178890782,105807520,128890782,2000
2003-07-02,1038,Shanghai Knights,50000000,88316835,60470220,38316835,2000
2003-07-02,4681,May,1750000,634803,145540,-1115197,2000
2003-07-03,600,Tears of the Sun,75000000,85632458,43632458,10632458,2000
2003-07-03,2313,Bringing Down the House,20000000,164675402,132675402,144675402,2000
2003-07-03,3811,Nowhere in Africa,6500000,6173485,6173485,-326515,2000
2003-07-03,3941,Irreversible,5400000,8133256,792200,2733256,2000
2003-07-11,1184,Love Actually,45000000,247950247,59472278,202950247,2000
2003-07-11,1662,Elf,32000000,220236410,173398518,188236410,2000
2003-07-18,219,Bad Boys II,130000000,273271982,138540870,143271982,2000
2003-07-18,1203,Johnny English,45000000,163126676,28013509,118126676,2000
2003-07-18,2752,How to Deal,16000000,14108518,14108518,-1891482,2000
2003-07-18,3394,Dirty Pretty Things,10000000,14156753,8112414,4156753,2000
2003-07-18,4607,This Thing of Ours,2000000,37227,37227,-1962773,2000
2003-07-24,3692,Masked and Anonymous,7500000,555335,533344,-6944665,2000
2003-07-25,420,Lara Croft: Tomb Raider: The Cradle of Life,90000000,157092943,65653758,67092943,2000
2003-07-25,438,Seabiscuit,86000000,148715342,120277854,62715342,2000
2003-07-25,1287,Spy Kids 3-D: Game Over,40000000,167851995,111760631,127851995,2000
2003-07-25,2930,Buffalo Soldiers,15000000,353743,353743,-14646257,2000
2003-07-25,4222,Mondays in the Sun,4000000,146402,146402,-3853598,2000
2003-08-08,645,S.W.A.T.,70000000,207154748,116877597,137154748,2000
2003-08-10,1723,Mystic River,30000000,156822020,90135191,126822020,2000
2003-08-15,1975,Open Range,26000000,68613992,58331254,42613992,2000
2003-08-15,2019,Freddy vs. Jason,25000000,114576403,82622655,89576403,2000
2003-08-15,4564,American Splendor,2000000,8685632,6003587,6685632,2000
2003-08-20,4567,Thirteen,2000000,9505996,4601043,7505996,2000
2003-08-22,1274,The Medallion,41000000,22108977,22108977,-18891023,2000
2003-08-22,2492,Marci X,20000000,1646664,1646664,-18353336,2000
2003-08-22,2984,My Boss's Daughter,14000000,15549702,15549702,1549702,2000
2003-08-22,4895,The Battle of Shaker Heights,1000000,839145,280351,-160855,2000
2003-08-29,2064,Jeepers Creepers II,25000000,119923801,35623801,94923801,2000
2003-08-29,4053,Party Monster,5000000,894030,742898,-4105970,2000
2003-08-29,5068,Civil Brand,500000,254293,254293,-245707,2000
2003-09-05,786,Daddy Day Care,60000000,164285587,104148781,104285587,2000
2003-09-05,4024,Les invasions barbares,5000000,25913869,8460000,20913869,2000
2003-09-07,234,Pirates of the Caribbean: The Curse of the Black Pearl,125000000,634954103,305411224,509954103,2000
2003-09-19,1774,Secondhand Lions,30000000,47902566,42070939,17902566,2000
2003-09-19,2241,Underworld,22000000,95708457,51970690,73708457,2000
2003-09-19,2637,Anything Else,18000000,13203044,3203044,-4796956,2000
2003-09-19,4876,Bubba Ho-Tep,1000000,1492895,1239183,492895,2000
2003-09-26,463,The Rundown,85000000,80831893,47641743,-4168107,2000
2003-09-26,1412,Duplex,40000000,10070651,9652000,-29929349,2000
2003-09-26,1618,Luther,35000000,32738814,5781086,-2261186,2000
2003-09-26,2584,Under the Tuscan Sun,18000000,57490024,43601508,39490024,2000
2003-09-26,3272,The Gospel of John,11000000,4234355,4068087,-6765645,2000
2003-09-26,4489,My Life Without Me,2500000,12267275,432360,9767275,2000
2003-10-01,2533,Just Married,19000000,101564935,56127162,82564935,2000
2003-10-01,5079,The Slaughter Rule,500000,13134,13134,-486866,2000
2003-10-10,847,Intolerable Cruelty,60000000,121327628,35327628,61327628,2000
2003-10-10,929,Kill Bill: Volume 1,55000000,176469428,70098138,121469428,2000
2003-10-10,2683,Good Boy!,17000000,45312217,37667746,28312217,2000
2003-10-10,3738,The House of the Dead,7000000,13767816,10199354,6767816,2000
2003-10-10,3887,The Flower of Evil,6000000,181798,181798,-5818202,2000
2003-10-12,657,Big Fish,70000000,123954323,66432867,53954323,2000
2003-10-17,2708,Veronica Guerin,17000000,9438074,1569918,-7561926,2000
2003-10-17,3511,The Texas Chainsaw Massacre,9000000,107967319,80571655,98967319,2000
2003-10-17,5159,Pieces of April,300000,3571253,2528664,3271253,2000
2003-10-22,3195,In the Cut,12000000,23693646,4717455,11693646,2000
2003-10-24,877,Beyond Borders,60000000,11427090,4426297,-48572910,2000
2003-10-24,1163,Scary Movie 3,45000000,155200000,110000082,110200000,2000
2003-10-24,1541,Radio,35000000,53293628,52333738,18293628,2000
2003-10-24,3651,The Singing Detective,8000000,524747,336456,-7475253,2000
2003-10-24,4392,Elephant,3000000,10051516,1266955,7051516,2000
2003-10-24,4930,The Party's Over,1000000,0,0,-1000000,2000
2003-10-31,3876,Shattered Glass,6000000,3456602,2207975,-2543398,2000
2003-11-04,902,Anger Management,56000000,195660942,135560942,139660942,2000
2003-11-04,3736,"House of 1,000 Corpses",7000000,17005466,12634962,10005466,2000
2003-11-04,4988,The Young Unknowns,800000,58163,58163,-741837,2000
2003-11-04,5188,Better Luck Tomorrow,250000,3809226,3802390,3559226,2000
2003-11-07,564,The League of Extraordinary Gentlemen,78000000,179265204,66465204,101265204,2000
2003-11-07,4652,Northfork,1900000,1445140,1420578,-454860,2000
2003-11-07,5077,The Journey,500000,19800,19800,-480200,2000
2003-11-14,204,Master and Commander: The Far Side of the World,135000000,212912137,93926386,77912137,2000
2003-11-14,545,Looney Tunes: Back in Action,80000000,54540662,20950820,-25459338,2000
2003-11-14,5157,Tupac Resurrection,300000,7808524,7718961,7508524,2000
2003-11-21,309,The Cat in the Hat,109000000,133818283,101018283,24818283,2000
2003-11-21,1323,Gothika,40000000,141484812,59588068,101484812,2000
2003-11-21,2420,21 Grams,20000000,59667625,16248701,39667625,2000
2003-11-26,416,The Haunted Mansion,90000000,155750628,75817994,65750628,2000
2003-11-26,547,Timeline,80000000,26703184,19480739,-53296816,2000
2003-11-26,745,The Missing,65000000,38253433,26900336,-26746567,2000
2003-11-26,2575,Bad Santa,18000000,77147031,60060328,59147031,2000
2003-11-26,4188,The Cooler,4000000,11131455,8291572,7131455,2000
2003-11-26,4560,Les Triplettes de Belleville,2000000,17403168,7301288,15403168,2000
2003-12-03,3915,Bend it Like Beckham,5600000,74566042,32543449,68966042,2000
2003-12-09,1868,Once Upon a Time in Mexico,29000000,97413527,56330657,68413527,2000
2003-12-09,4164,Lost in Translation,4000000,117085297,44585453,113085297,2000
2003-12-09,4581,"The Book of Mormon Movie, Volume 1: The Journey",2000000,1660865,1660865,-339135,2000
2003-12-09,4708,Cabin Fever,1500000,30351664,21158188,28851664,2000
2003-12-12,501,Something's Gotta Give,80000000,266685242,124685242,186685242,2000
2003-12-12,951,Stuck On You,55000000,63537164,33832741,8537164,2000
2003-12-12,1963,The Statement,27000000,1545064,765637,-25454936,2000
2003-12-12,3178,Girl with a Pearl Earring,12000000,43281552,11634362,31281552,2000
2003-12-17,383,The Lord of the Rings: The Return of the King,94000000,1141403341,377845905,1047403341,2000
2003-12-19,729,Mona Lisa Smile,65000000,141205169,63803100,76205169,2000
2003-12-19,2721,House of Sand and Fog,16500000,16157923,13005485,-342077,2000
2003-12-19,3336,Calendar Girls,10000000,93074616,31011616,83074616,2000
2003-12-19,4777,The Hebrew Hammer,1300000,90213,77755,-1209787,2000
2003-12-24,3971,Monster,5000000,64240813,34469210,59240813,2000
2003-12-25,355,Peter Pan,100000000,95255485,48417850,-4744515,2000
2003-12-25,511,Cold Mountain,80000000,165173909,95632614,85173909,2000
2003-12-25,822,Paycheck,60000000,98819789,53789313,38819789,2000
2003-12-25,1282,Cheaper by the Dozen,40000000,190212113,138614544,150212113,2000
2003-12-25,2918,The Company,15000000,3396508,2281585,-11603492,2000
2003-12-31,1862,Ripley's Game,30000000,0,0,-30000000,2000
2003-12-31,4236,Nothing,4000000,63180,0,-3936820,2000
2003-12-31,5365,Flywheel,20000,0,0,-20000,2000
2004-01-01,5386,The Mongol King,7000,900,900,-6100,2000
2004-01-09,2211,Vanity Fair,23000000,19123851,16123851,-3876149,2000
2004-01-10,580,Shark Tale,75000000,371917043,161412000,296917043,2000
2004-01-10,806,Ladder 49,60000000,102332848,74541707,42332848,2000
2004-01-10,2265,I Heart Huckabees,22000000,20034713,12784713,-1965287,2000
2004-01-10,4368,Woman Thou Art Loosed,3000000,6879730,6879730,3879730,2000
2004-01-16,1250,Along Came Polly,42000000,173044410,88073507,131044410,2000
2004-01-16,1389,Torque,40000000,46176322,21176322,6176322,2000
2004-01-16,3405,Teacher's Pet: The Movie,10000000,6491969,6491969,-3508031,2000
2004-01-23,2184,Win a Date with Tad Hamilton!,24000000,16980098,16980098,-7019902,2000
2004-01-23,3037,The Butterfly Effect,13000000,95638592,57924679,82638592,2000
2004-01-23,4568,Touching the Void,2000000,15396525,4593598,13396525,2000
2004-01-30,1113,The Big Bounce,50000000,6626115,6471394,-43373885,2000
2004-01-30,3605,You Got Served,8000000,50811858,40066497,42811858,2000
2004-01-30,4971,Latter Days,850000,865708,833118,15708,2000
2004-01-30,5059,Osama,500000,1971479,1127331,1471479,2000
2004-02-04,303,Home on the Range,110000000,76482461,50026353,-33517539,2000
2004-02-04,815,Hellboy,60000000,99823958,59623958,39823958,2000
2004-02-04,904,Walking Tall,56000000,47313824,46213824,-8686176,2000
2004-02-04,1797,The Prince & Me,30000000,29356757,28165882,-643243,2000
2004-02-04,3447,Shaolin Soccer,10000000,42776032,488872,32776032,2000
2004-02-07,4565,Before Sunset,2000000,11234552,5792822,9234552,2000
2004-02-13,584,50 First Dates,75000000,196320329,120776832,121320329,2000
2004-02-20,1442,Against the Ropes,39000000,6429865,5881504,-32570135,2000
2004-02-20,1992,Welcome to Mooseport,26000000,14469428,14469428,-11530572,2000
2004-02-20,2096,Eurotrip,25000000,20718223,17718223,-4281777,2000
2004-02-20,2844,Confessions of a Teenage Drama Queen,15000000,33118854,29331068,18118854,2000
2004-02-20,3298,The Blue Butterfly,10400000,1610194,1610194,-8789806,2000
2004-02-25,2006,The Passion of the Christ,25000000,622341924,370782930,597341924,2000
2004-02-27,1089,Twisted,50000000,40119848,25195050,-9880152,2000
2004-02-27,3580,Club Dread,8500000,7573551,5001655,-926449,2000
2004-02-27,3821,"Good Bye, Lenin!",6400000,79384539,4063859,72984539,2000
2004-02-27,4066,Decoys,5000000,96760,84733,-4903240,2000
2004-03-09,1827,Wicker Park,30000000,21577076,13001257,-8422924,2000
2004-03-09,2423,Paparazzi,20000000,16612072,15712072,-3387928,2000
2004-03-09,2758,The Cookout,16000000,11540112,11540112,-4459888,2000
2004-03-09,3114,Tae Guik Gi: The Brotherhood of War,12500000,69826708,1110186,57326708,2000
2004-03-09,3797,"Remember Me, My Love",6700000,223878,223878,-6476122,2000
2004-03-12,1560,Closer,35000000,116177695,33987757,81177695,2000
2004-03-12,3181,House of Flying Daggers,12000000,92863945,11050094,80863945,2000
2004-03-19,1895,Dawn of the Dead,28000000,103452875,58990765,75452875,2000
2004-03-19,2365,Eternal Sunshine of the Spotless Mind,20000000,72703462,34366518,52703462,2000
2004-03-19,2488,Bon Voyage,20000000,8361736,2353728,-11638264,2000
2004-03-26,1551,The Ladykillers,35000000,77392139,39692139,42392139,2000
2004-03-26,1577,Jersey Girl,35000000,37066129,25266129,2066129,2000
2004-03-26,2017,Scooby-Doo 2: Monsters Unleashed,25000000,181185387,84185387,156185387,2000
2004-03-31,2513,The Touch,20000000,5918742,0,-14081258,2000
2004-04-06,212,Harry Potter and the Prisoner of Azkaban,130000000,796688549,249538952,666688549,2000
2004-04-16,932,Kill Bill: Volume 2,55000000,153535982,66207920,98535982,2000
2004-04-16,1649,The Punisher,33000000,54533774,33664370,21533774,2000
2004-04-16,2463,Connie & Carla,20000000,8047525,8047525,-11952475,2000
2004-04-23,800,Man on Fire,60000000,130968579,77906816,70968579,2000
2004-04-23,1749,13 Going On 30,30000000,96439723,57139723,66439723,2000
2004-04-23,3584,Silmido,8500000,30298347,298347,21798347,2000
2004-04-23,4307,L'incomparable mademoiselle C.,3400000,493905,493905,-2906095,2000
2004-04-30,1681,Laws of Attraction,32000000,29948322,17848322,-2051678,2000
2004-04-30,1825,Godsend,30000000,16910708,14334645,-13089292,2000
2004-04-30,2435,Envy,20000000,14566246,13548322,-5433754,2000
2004-04-30,2569,Mean Girls,18000000,130953026,86047227,112953026,2000
2004-04-30,2704,Bobby Jones: Stroke of Genius,17000000,2694071,2694071,-14305929,2000
2004-05-03,563,Hidalgo,78000000,108086731,67286731,30086731,2000
2004-05-03,795,Starsky & Hutch,60000000,170200225,88200225,110200225,2000
2004-05-11,390,The Incredibles,92000000,614726752,261441092,522726752,2000
2004-05-11,1406,Alfie,40000000,35195939,13395939,-4804061,2000
2004-05-14,157,Troy,150000000,484161265,133298577,334161265,2000
2004-05-14,3530,Breakin' All the Rules,9000000,12512317,12232382,3512317,2000
2004-05-19,635,Shrek 2,70000000,937008132,441226247,867008132,2000
2004-05-28,241,The Day After Tomorrow,125000000,556319450,186740799,431319450,2000
2004-05-28,1069,Raising Helen,50000000,49928680,37485528,-71320,2000
2004-05-28,2754,Soul Plane,16000000,14553807,13922211,-1446193,2000
2004-05-28,4023,Saved!,5000000,10206551,8886160,5206551,2000
2004-05-28,5378,On the Down Low,10000,1987,1987,-8013,2000
2004-06-02,1892,Miracle,28000000,64474705,64378093,36474705,2000
2004-06-02,2573,Barbershop 2: Back in Business,18000000,65842412,65070412,47842412,2000
2004-06-02,2609,Catch That Kid,18000000,16959614,16703799,-1040386,2000
2004-06-02,2929,The Return,15000000,5953886,501752,-9046114,2000
2004-06-02,4182,What the #$'! Do We Know,4000000,10941801,10941801,6941801,2000
2004-06-02,5302,The Lost Skeleton of Cadavra,100000,110536,110536,10536,2000
2004-06-08,789,Collateral,60000000,217670152,100170152,157670152,2000
2004-06-08,1807,Little Black Book,30000000,21758371,20422207,-8241629,2000
2004-06-08,3694,Code 46,7500000,1788324,197148,-5711676,2000
2004-06-08,4993,Saints and Soldiers,780000,1310470,1310470,530470,2000
2004-06-08,5050,Open Water,500000,55518641,30500882,55018641,2000
2004-06-10,5129,Tarnation,400000,1162014,592014,762014,2000
2004-06-16,307,Around the World in 80 Days,110000000,72004159,24004159,-37995841,2000
2004-06-18,590,The Terminal,75000000,218673959,77073959,143673959,2000
2004-06-18,1715,Dodgeball: A True Underdog Story,30000000,167791704,114326736,137791704,2000
2004-06-18,4815,Grand Theft Parsons,1200000,0,0,-1200000,2000
2004-06-23,2328,White Chicks,20000000,111448997,69148997,91448997,2000
2004-06-23,3830,Fahrenheit 9/11,6000000,221148959,119114517,215148959,2000
2004-06-25,631,Two Brothers,72000000,62176754,19176754,-9823246,2000
2004-06-25,1728,The Notebook,30000000,116025023,81001787,86025023,2000
2004-06-25,2875,De-Lovely,15000000,18524496,13337299,3524496,2000
2004-06-30,43,Spider-Man 2,200000000,783705001,373524485,583705001,2000
2004-07-04,3149,Johnson Family Vacation,12000000,31286759,31203964,19286759,2000
2004-07-05,104,Van Helsing,170000000,300150546,120150546,130150546,2000
2004-07-05,1404,New York Minute,40000000,21215882,14018364,-18784118,2000
2004-07-05,4987,The Mudge Boy,800000,62544,62544,-737456,2000
2004-07-05,5323,Super Size Me,65000,22233808,11529368,22168808,2000
2004-07-07,426,King Arthur,90000000,203877963,51877963,113877963,2000
2004-07-16,312,"I, Robot",105000000,348629585,144801023,243629585,2000
2004-07-16,2535,A Cinderella Story,19000000,70164105,51438175,51164105,2000
2004-07-16,4107,Camping Sauvage,4600000,3479302,3479302,-1120698,2000
2004-07-16,4323,Maria Full of Grace,3200000,14441158,6529624,11241158,2000
2004-07-23,356,Catwoman,100000000,82145379,40202379,-17854621,2000
2004-07-23,442,The Bourne Supremacy,85000000,288587450,176087450,203587450,2000
2004-07-23,3817,A Home at the End of the World,6500000,1033810,1029017,-5466190,2000
2004-07-28,4472,Garden State,2500000,36028802,26782316,33528802,2000
2004-07-30,525,The Manchurian Candidate,80000000,96148711,65948711,16148711,2000
2004-07-30,632,The Village,71682975,257641634,114197520,185958659,2000
2004-07-30,964,Thunderbirds,55000000,28231444,6768055,-26768556,2000
2004-07-30,3523,Harold & Kumar Go to White Castle,9000000,18225165,18225165,9225165,2000
2004-08-10,1743,Friday Night Lights,30000000,61950770,61255921,31950770,2000
2004-08-10,2889,Raise Your Voice,15000000,14811980,10411980,-188020,2000
2004-08-10,5384,Primer,7000,841926,424760,834926,2000
2004-08-12,734,Blade: Trinity,65000000,132397389,52397389,67397389,2000
2004-08-13,651,AVP: Alien Vs. Predator,70000000,172543519,80281096,102543519,2000
2004-08-13,2405,Yu-Gi-Oh,20000000,28762690,19762690,8762690,2000
2004-08-20,565,Exorcist: The Beginning,78000000,43957541,41814863,-34042459,2000
2004-08-20,1748,Without a Paddle,30000000,65121280,58156435,35121280,2000
2004-08-20,5063,Mean Creek,500000,1348750,603951,848750,2000
2004-08-27,1957,Suspect Zero,27000000,8712564,8712564,-18287436,2000
2004-08-27,2073,Anacondas: The Hunt for the Blood Orchid,25000000,70326393,31526393,45326393,2000
2004-08-27,2456,Super Babies: Baby Geniuses 2,20000000,9355369,9109322,-10644631,2000
2004-08-27,2677,Jet Li's Hero,17000000,177535958,53652140,160535958,2000
2004-08-27,3448,The Brown Bunny,10000000,630427,366301,-9369573,2000
2004-09-01,2216,Chasing Liberty,23000000,12291975,12189514,-10708025,2000
2004-09-01,3169,My Baby's Daddy,12000000,17322212,17321573,5322212,2000
2004-09-04,392,The Alamo,92000000,23911362,22406362,-68088638,2000
2004-09-04,1583,Ella Enchanted,35000000,22913677,22913677,-12086323,2000
2004-09-04,1821,The Whole Ten Yards,30000000,26323969,16323969,-3676031,2000
2004-09-04,2108,The Girl Next Door,25000000,31635150,14589444,6635150,2000
2004-09-04,3795,Shade,6800000,9533964,25032,2733964,2000
2004-09-07,2018,Anchorman: The Legend of Ron Burgundy,25000000,89476265,84136909,64476265,2000
2004-09-07,3390,Sleepover,10000000,9408183,9408183,-591817,2000
2004-09-07,4462,Riding Giants,2600000,3292333,2276368,692333,2000
2004-09-17,670,Sky Captain and the World of Tomorrow,70000000,49730854,37760080,-20269146,2000
2004-09-17,1595,Wimbledon,35000000,41666476,16862585,6666476,2000
2004-09-17,1805,Mr. 3000,30000000,21827296,21800302,-8172704,2000
2004-09-17,4760,Incident at Loch Ness,1400000,56073,36830,-1343927,2000
2004-09-24,1036,The Forgotten,50000000,117211892,66711892,67211892,2000
2004-09-24,1429,The Last Shot,40000000,463730,463730,-39536270,2000
2004-09-24,1836,First Daughter,30000000,10419084,9055010,-19580916,2000
2004-09-24,4006,Shaun of the Dead,5000000,30332385,13542874,25332385,2000
2004-09-24,4898,Guiana 1838,1000000,227241,227241,-772759,2000
2004-10-09,1048,Resident Evil: Apocalypse,50000000,125168734,50740078,75168734,2000
2004-10-09,1201,Cellular,45000000,61475984,32003620,16475984,2000
2004-10-09,5243,Malevolence,200000,346106,126021,146106,2000
2004-10-10,3273,Vera Drake,11000000,13353855,3753806,2353855,2000
2004-10-11,101,The Polar Express,170000000,319090241,194949659,149090241,2000
2004-10-12,289,Ocean's Twelve,110000000,362989076,125531634,252989076,2000
2004-10-12,1090,The Life Aquatic with Steve Zissou,50000000,34806726,24006726,-15193274,2000
2004-10-12,4623,Freeze Frame,2000000,105377,0,-1894623,2000
2004-10-12,5134,Fabled,400000,31425,31425,-368575,2000
2004-10-15,1326,Shall We Dance?,40000000,118097882,57887882,78097882,2000
2004-10-15,2370,Team America: World Police,20000000,50948811,32774834,30948811,2000
2004-10-15,2621,Being Julia,18000000,14488705,7739049,-3511295,2000
2004-10-15,3466,Eulogy,10000000,70527,70527,-9929473,2000
2004-10-22,2671,Sideways,17000000,109793192,71502303,92793192,2000
2004-10-22,3304,The Grudge,10000000,187281115,110359362,177281115,2000
2004-10-22,4050,The Machinist,5000000,8655397,1082044,3655397,2000
2004-10-22,5237,Short Cut to Nirvana: Kumbh Mela,200000,439651,381225,239651,2000
2004-10-29,1309,Ray,40000000,124823094,75305995,84823094,2000
2004-10-29,2479,Birth,20000000,14603001,5005899,-5396999,2000
2004-10-29,4792,Saw,1200000,103880027,55968727,102680027,2000
2004-11-06,266,The Chronicles of Riddick,120000000,107212751,57712751,-12787249,2000
2004-11-06,349,The Stepford Wives,100000000,96221971,59475623,-3778029,2000
2004-11-06,1031,Garfield,50000000,208094550,75367693,158094550,2000
2004-11-06,5124,Napoleon Dynamite,400000,46122713,44540956,45722713,2000
2004-11-08,1167,The Princess Diaries 2: Royal Engagement,45000000,122071435,95149435,77071435,2000
2004-11-19,330,National Treasure,100000000,331323410,173005002,231323410,2000
2004-11-19,1726,SpongeBob SquarePants: The Movie,30000000,142051255,85416609,112051255,2000
2004-11-19,4034,La mala educación,5000000,40311842,5211842,35311842,2000
2004-11-24,130,Alexander,155000000,167297191,34297191,12297191,2000
2004-11-24,1032,Christmas with the Kranks,50000000,96469187,73701902,46469187,2000
2004-11-24,3689,The Work and the Glory,7500000,3347647,3347647,-4152353,2000
2004-11-26,965,Un long dimanche de fiançailles,55000000,69759296,6167817,14759296,2000
2004-11-26,3930,Les Choristes,5500000,83529758,3629758,78029758,2000
2004-12-03,1341,Secret Window,40000000,92111551,47958031,52111551,2000
2004-12-03,1989,Agent Cody Banks 2: Destination London,26000000,28703083,23514247,2703083,2000
2004-12-11,900,After the Sunset,57000000,38329114,28328132,-18670886,2000
2004-12-11,1064,Bridget Jones: The Edge Of Reason,50000000,263894551,40203020,213894551,2000
2004-12-11,1873,Seed of Chucky,29000000,24716190,17016190,-4283810,2000
2004-12-11,2040,Finding Neverland,25000000,115036108,51676606,90036108,2000
2004-12-11,3269,Kinsey,11000000,13000959,10214647,2000959,2000
2004-12-11,3753,Veer-Zaara,7000000,7017859,2938532,17859,2000
2004-12-15,1721,Million Dollar Baby,30000000,231928227,100492203,201928227,2000
2004-12-17,293,The Aviator,110000000,208370892,102608827,98370892,2000
2004-12-17,337,Lemony Snicket's A Series of Unfortunate Events,100000000,212956024,118627117,112956024,2000
2004-12-17,602,Spanglish,75000000,54344321,42044321,-20655679,2000
2004-12-17,611,Flight of the Phoenix,75000000,34009180,21009180,-40990820,2000
2004-12-17,2190,Beyond the Sea,24000000,8292914,6144806,-15707086,2000
2004-12-17,3029,Mar adentro,13300000,39686345,2086345,26386345,2000
2004-12-17,3452,Imaginary Heroes,10000000,290875,228524,-9709125,2000
2004-12-22,773,Meet the Fockers,60000000,516567575,279167575,456567575,2000
2004-12-22,940,The Phantom of the Opera,55000000,154017885,51225796,99017885,2000
2004-12-22,2661,Hotel Rwanda,17500000,36521223,23519128,19021223,2000
2004-12-25,1193,Fat Albert,45000000,48563556,48114556,3563556,2000
2004-12-25,3292,Darkness,10600000,34409206,22163442,23809206,2000
2004-12-29,1844,The Merchant of Venice,30000000,18765585,3765585,-11234415,2000
2004-12-29,1982,In Good Company,26000000,63489752,45489752,37489752,2000
2004-12-31,1690,George and the Dragon,32000000,0,0,-32000000,2000
2004-12-31,3565,The I Inside,8800000,0,0,-8800000,2000
2004-12-31,5251,Samantha: An American Girl Holiday,200000,0,0,-200000,2000
2005-01-04,1310,Sin City,40000000,158527918,74103820,118527918,2000
2005-01-06,2057,The Sisterhood of the Traveling Pants,25000000,41560117,39053061,16560117,2000
2005-01-07,1215,Rebound,45000000,17492014,16809014,-27507986,2000
2005-01-07,3933,De battre mon coeur s'est arrêté,5500000,8589831,1023424,3089831,2000
2005-01-07,5002,Undead,750000,229250,41196,-520750,2000
2005-01-14,746,Elektra,65000000,56409722,24409722,-8590278,2000
2005-01-14,1178,Coach Carter,45000000,76665507,67264877,31665507,2000
2005-01-14,1763,Racing Stripes,30000000,89955540,49772522,59955540,2000
2005-01-19,1809,Assault On Precinct 13,30000000,36040895,20040895,6040895,2000
2005-01-21,2321,Are We There Yet?,20000000,98114471,82674398,78114471,2000
2005-01-21,5122,Gory Gory Hallelujah,425000,12604,12604,-412396,2000
2005-01-28,2042,Hide and Seek,25000000,123696741,51100486,98696741,2000
2005-01-28,2478,Alone in the Dark,20000000,8178569,5178569,-11821431,2000
2005-01-28,4070,Fascination,5000000,83356,16670,-4916644,2000
2005-01-28,5318,"Peace, Propaganda and the Promised Land",70000,4930,4930,-65070,2000
2005-02-09,555,A Sound of Thunder,80000000,6300451,1900451,-73699549,2000
2005-02-09,1672,The Transporter 2,32000000,88978458,43095856,56978458,2000
2005-02-09,2134,Underclassman,25000000,5654777,5654777,-19345223,2000
2005-02-12,955,Aeon Flux,55000000,53913573,25857987,-1086427,2000
2005-02-18,363,Son of the Mask,100000000,59918422,17018422,-40081578,2000
2005-02-18,591,Constantine,75000000,221594911,75976178,146594911,2000
2005-02-18,2837,Because of Winn-Dixie,15000000,33508485,32647042,18508485,2000
2005-02-18,3025,Der Untergang,13500000,93631744,5501940,80131744,2000
2005-02-25,1097,Man of the House,50000000,22099706,19699706,-27900294,2000
2005-02-25,1590,Cursed,35000000,25114901,19294901,-9885099,2000
2005-02-25,3923,Diary of a Mad Black Woman,5500000,50458356,50406346,44958356,2000
2005-03-06,435,Cinderella Man,88000000,105021488,61649911,17021488,2000
2005-03-06,2120,The Lords of Dogtown,25000000,13424365,11273517,-11575635,2000
2005-03-08,4868,Junebug,1000000,3553253,2678010,2553253,2000
2005-03-18,1028,The Ring Two,50000000,161941727,75941727,111941727,2000
2005-03-18,2084,Ice Princess,25000000,25732334,24381334,732334,2000
2005-03-18,2501,Steamboy,20000000,10468867,468867,-9531133,2000
2005-03-18,4920,The Helix…Loaded,1000000,3700,3700,-996300,2000
2005-03-24,829,Miss Congeniality 2: Armed and Fabulous,60000000,101382396,48478006,41382396,2000
2005-03-25,1527,Guess Who,35000000,102115888,68915888,67115888,2000
2005-03-25,4290,D.E.B.S.,3500000,96793,96793,-3403207,2000
2005-03-25,4394,Oldboy,3000000,6239723,707391,3239723,2000
2005-03-25,4727,The Ballad of Jack and Rose,1500000,1126258,712294,-373742,2000
2005-03-30,2062,Beauty Shop,25000000,38351350,36351350,13351350,2000
2005-04-02,2345,Boogeyman,20000000,67192859,46752382,47192859,2000
2005-04-02,2838,The Wedding Date,15000000,47175038,31726995,32175038,2000
2005-04-03,596,Be Cool,75000000,94944017,55849401,19944017,2000
2005-04-03,903,The Pacifier,56000000,198006880,113006880,142006880,2000
2005-04-03,1880,The Jacket,28500000,15452978,6301131,-13047022,2000
2005-04-03,4109,Dear Frankie,4600000,3099369,1340891,-1500631,2000
2005-04-11,628,Jarhead,72000000,96947540,62647540,24947540,2000
2005-04-11,779,Chicken Little,60000000,310043823,135386665,250043823,2000
2005-04-11,4704,I Love Your Work,1600000,3264,3264,-1596736,2000
2005-04-11,4747,Wal-Mart: The High Cost of Low Price,1500000,58692,0,-1441308,2000
2005-04-11,5137,Show Me,400000,0,0,-400000,2000
2005-04-15,2558,The Amityville Horror,18500000,109175673,65233369,90675673,2000
2005-04-15,4593,House of D,2000000,466106,388532,-1533894,2000
2005-04-15,4600,It's All Gone Pete Tong,2000000,2226603,120620,226603,2000
2005-04-22,418,The Interpreter,90000000,162753837,72708161,72753837,2000
2005-04-22,2089,A Lot Like Love,25000000,41921590,21835784,16921590,2000
2005-04-22,2139,King's Ransom,25000000,4049527,4008527,-20950473,2000
2005-04-22,2502,The Game of Their Lives,20000000,375474,375474,-19624526,2000
2005-04-22,2783,Madison,15500000,517262,517262,-14982738,2000
2005-04-29,858,XXX: State of the Union,60000000,71073932,26873932,11073932,2000
2005-04-29,1191,The Hitchhiker's Guide to the Galaxy,45000000,102746214,51019112,57746214,2000
2005-04-29,4758,Holy Girl,1400000,1261792,304124,-138208,2000
2005-04-29,5350,Funny Ha Ha,30000,82698,77070,52698,2000
2005-05-08,977,The Dukes of Hazzard,53000000,109848461,80270227,56848461,2000
2005-05-08,3206,2046,12000000,19287485,1442338,7287485,2000
2005-05-08,3794,The Chumscrubber,6800000,49526,49526,-6750474,2000
2005-05-08,3950,Saint Ralph,5200000,1695126,795126,-3504874,2000
2005-05-08,5391,My Date With Drew,1100,181041,181041,179941,2000
2005-05-10,1751,Wallace & Gromit: The Curse of the Were-Rabbit,30000000,197593152,56068547,167593152,2000
2005-05-10,4714,The Squid and the Whale,1500000,11191423,7372734,9691423,2000
2005-05-13,1172,Monster-in-Law,45000000,155931301,82931301,110931301,2000
2005-05-13,1190,Kicking and Screaming,45000000,55842724,52842724,10842724,2000
2005-05-13,1242,Danny the Dog,43000000,49037621,24537621,6037621,2000
2005-05-13,1961,Mindhunters,27000000,16566235,4476235,-10433765,2000
2005-05-13,3813,Layer Cake,6500000,11745931,2339957,5245931,2000
2005-05-13,5052,Mad Hot Ballroom,500000,9387581,8117961,8887581,2000
2005-05-19,273,Star Wars Ep. III: Revenge of the Sith,115000000,848998877,380270577,733998877,2000
2005-05-27,482,The Longest Yard,82000000,190320568,158119460,108320568,2000
2005-05-27,578,Madagascar,75000000,556559566,193595521,481559566,2000
2005-05-27,4486,Saving Face,2500000,1269705,1187266,-1230295,2000
2005-06-05,305,Kingdom of Heaven,110000000,218853353,47398413,108853353,2000
2005-06-05,1565,House of Wax,35000000,70064800,32064800,35064800,2000
2005-06-05,3701,Crash,7303082,101173038,55334418,93869956,2000
2005-06-05,5172,Fighting Tommy Riley,300000,10514,10514,-289486,2000
2005-06-15,146,Batman Begins,150000000,359142722,205343774,209142722,2000
2005-06-17,3369,The Perfect Man,10000000,19535005,16535005,9535005,2000
2005-06-17,4571,Me and You and Everyone We Know,2000000,9615464,3885134,7615464,2000
2005-06-17,4690,My Summer of Love,1700000,4727375,1000915,3027375,2000
2005-06-22,1037,Herbie: Fully Loaded,50000000,144110682,66010682,94110682,2000
2005-06-24,527,Bewitched,80000000,131159306,63313159,51159306,2000
2005-06-24,2556,George A. Romero's Land of the Dead,18975000,47751015,20700082,28776015,2000
2005-06-24,4303,La marche de l'empereur,3400000,133276359,77437223,129876359,2000
2005-06-24,4691,Yes,1700000,661221,396035,-1038779,2000
2005-06-24,5011,Rize,700000,4857731,3278611,4157731,2000
2005-06-29,209,War of the Worlds,132000000,606836535,234280354,474836535,2000
2005-07-01,3313,White Noise,10000000,92094360,56094360,82094360,2000
2005-07-01,4672,Travellers and Magicians,1800000,1322161,506793,-477839,2000
2005-07-01,5247,Solitude,200000,6260,6260,-193740,2000
2005-07-10,2396,2 For the Money,20000000,30491379,22991379,10491379,2000
2005-07-10,3718,"Good Night, and Good Luck",7000000,56586901,31501218,49586901,2000
2005-07-10,4823,Waiting...,1125000,18673274,16124543,17548274,2000
2005-07-12,2136,The World's Fastest Indian,25000000,18991288,5128124,-6008712,2000
2005-07-13,5388,Return to the Land of Wonders,5000,1338,1338,-3662,2000
2005-07-15,143,Charlie and the Chocolate Factory,150000000,475825484,206459076,325825484,2000
2005-07-15,1277,The Wedding Crashers,40000000,283218368,209218368,243218368,2000
2005-07-15,5164,First Morning,300000,87264,87264,-212736,2000
2005-07-15,5201,On the Outs,250000,237816,49772,-12184,2000
2005-07-22,269,The Island,120000000,163018913,35818913,43018913,2000
2005-07-22,1563,The Bad News Bears,35000000,33500620,32868349,-1499380,2000
2005-07-22,3730,The Devil's Rejects,7000000,20940428,17044981,13940428,2000
2005-07-22,4444,Hustle & Flow,2800000,23591783,22202809,20791783,2000
2005-07-22,5196,November,250000,191862,191862,-58138,2000
2005-07-29,195,Stealth,138000000,76416746,32116746,-61583254,2000
2005-07-29,1530,Sky High,35000000,83109359,63939454,48109359,2000
2005-07-29,1546,Must Love Dogs,35000000,58405313,43894863,23405313,2000
2005-08-04,178,Sahara,145000000,121671925,68671925,-23328075,2000
2005-08-04,1350,Fever Pitch,40000000,50071069,42071069,10071069,2000
2005-08-04,2418,Kung Fu Hustle,20000000,102034104,17104669,82034104,2000
2005-08-07,436,Fantastic Four,87500000,330717080,154696080,243217080,2000
2005-08-07,861,Dark Water,60000000,49473093,25473093,-10526907,2000
2005-08-07,5146,Murderball,350000,1772979,1531154,1422979,2000
2005-08-17,1846,Supercross,30000000,3252550,3102550,-26747450,2000
2005-08-19,1588,Valiant,35000000,64188387,19478106,29188387,2000
2005-08-19,1968,The 40 Year-old Virgin,26000000,177344230,109449237,151344230,2000
2005-08-19,1976,Red Eye,26000000,96666486,57891803,70666486,2000
2005-08-26,536,The Brothers Grimm,80000000,105299638,37899638,25299638,2000
2005-08-26,1824,The Cave,30000000,27147991,15007991,-2852009,2000
2005-08-26,3544,Undiscovered,9000000,1069318,1069318,-7930682,2000
2005-08-31,2004,The Constant Gardener,25500000,86301599,33579798,60801599,2000
2005-09-09,1837,An Unfinished Life,30000000,18535575,8535575,-11464425,2000
2005-09-09,2460,The Man,20000000,10393696,8330720,-9606304,2000
2005-09-09,2571,The Exorcism of Emily Rose,18000000,144529078,75072454,126529078,2000
2005-09-09,5244,Side Effects,200000,44701,44701,-155299,2000
2005-09-11,1371,Get Rich or Die Tryin',40000000,46666955,30981850,6666955,2000
2005-09-12,72,"The Chronicles of Narnia: The Lion, the Witch and the Wardrobe",180000000,720539572,291710957,540539572,2000
2005-09-12,460,Memoirs of a Geisha,85000000,161510853,57010853,76510853,2000
2005-09-12,2448,Mrs. Henderson Presents,20000000,27836366,11036366,7836366,2000
2005-09-12,3016,Brokeback Mountain,13900000,177012173,83043761,163112173,2000
2005-09-12,4776,Neal n' Nikki,1300000,329621,100358,-970379,2000
2005-09-16,887,Just Like Heaven,58000000,100687083,48318130,42687083,2000
2005-09-16,1263,Lord of War,42000000,60437727,24149632,18437727,2000
2005-09-16,2147,Venom,25000000,881745,881745,-24118255,2000
2005-09-16,2467,Proof,20000000,8284331,7535331,-11715669,2000
2005-09-16,4206,Thumbsucker,4000000,1919197,1328679,-2080803,2000
2005-09-16,4851,Cry Wolf,1000000,15943081,10047674,14943081,2000
2005-09-16,4907,Chocolate: Deep Dark Secrets,1000000,1549000,49000,549000,2000
2005-09-23,753,Oliver Twist,65000000,26670920,2070920,-38329080,2000
2005-09-23,923,Flightplan,55000000,214392904,89706988,159392904,2000
2005-09-23,1678,A History of Violence,32000000,61477797,31493782,29477797,2000
2005-09-23,1753,The Corpse Bride,30000000,114770654,53359111,84770654,2000
2005-09-23,3366,Roll Bounce,10000000,17433072,17380866,7433072,2000
2005-09-23,3663,Dear Wendy,8000000,446438,23106,-7553562,2000
2005-09-23,4701,Dil Jo Bhi Kahey...,1600000,129319,129319,-1470681,2000
2005-09-23,4932,Proud,1000000,0,0,-1000000,2000
2005-09-28,4742,Forty Shades of Blue,1500000,172569,75828,-1327431,2000
2005-09-30,1100,Into the Blue,50000000,41982227,18782227,-8017773,2000
2005-09-30,1441,Serenity,39000000,40319440,25514517,1319440,2000
2005-09-30,2104,The Greatest Game Ever Played,25000000,15468266,15331289,-9531734,2000
2005-09-30,3208,Duma,12000000,994790,870067,-11005210,2000
2005-09-30,3719,Capote,7000000,49924079,28750530,42924079,2000
2005-09-30,4208,MirrorMask,4000000,973613,864959,-3026387,2000
2005-09-30,4414,My Big Fat Independent Movie,3000000,4655,4655,-2995345,2000
2005-10-06,284,Mr. and Mrs. Smith,110000000,486124090,186336279,376124090,2000
2005-10-06,1066,The Adventures of Sharkboy and Lavagirl in 3-D,50000000,69425966,39177684,19425966,2000
2005-10-06,1954,The Honeymooners,27000000,13174426,12834849,-13825574,2000
2005-10-06,2191,Hauru no ugoku shiro,24000000,237814327,4710455,213814327,2000
2005-10-06,2194,The Bridge of San Luis Rey,24000000,1696765,49981,-22303235,2000
2005-10-06,4441,High Tension,2850000,6435262,3681066,3585262,2000
2005-10-13,5135,The Dark Hours,400000,423,423,-399577,2000
2005-10-14,974,Elizabethtown,54000000,50719373,26850426,-3280627,2000
2005-10-14,1108,Domino,50000000,22969202,10169202,-27030798,2000
2005-10-14,2148,Where the Truth Lies,25000000,1415656,872142,-23584344,2000
2005-10-14,2592,The Fog,18000000,37048526,29511112,19048526,2000
2005-10-21,673,Doom,70000000,54612337,28212337,-15387663,2000
2005-10-21,1677,Dreamer: Inspired by a True Story,32000000,39498360,33022286,7498360,2000
2005-10-21,1814,North Country,30000000,23676771,18324242,-6323229,2000
2005-10-21,2912,"Kiss Kiss, Bang Bang",15000000,16829464,4235837,1829464,2000
2005-10-21,3685,Shopgirl,7500000,11758418,10284523,4258418,2000
2005-10-21,3815,The Work and the Glory: American Zion,6500000,2025032,2025032,-4474968,2000
2005-10-21,5082,The Californians,500000,4134,4134,-495866,2000
2005-10-28,532,The Legend of Zorro,80000000,141475336,45575336,61475336,2000
2005-10-28,2442,The Weather Man,20000000,15466961,12482775,-4533039,2000
2005-10-28,3957,Saw II,5000000,152925093,87025093,147925093,2000
2005-11-02,908,Hitch,55000000,366784257,177784257,311784257,2000
2005-11-02,2413,Pooh's Heffalump Movie,20000000,55686944,18098433,35686944,2000
2005-11-02,3746,Bride & Prejudice,7000000,25269040,6601079,18269040,2000
2005-11-02,4588,Inside Deep Throat,2000000,691880,691880,-1308120,2000
2005-11-03,499,Robots,80000000,260700012,128200012,180700012,2000
2005-11-03,607,Hostage,75000000,77636443,34636443,2636443,2000
2005-11-03,3166,The Upside of Anger,12000000,28915761,18761993,16915761,2000
2005-11-11,744,Zathura,65000000,58545540,28045540,-6454460,2000
2005-11-11,1905,Pride & Prejudice,28000000,126549607,38372662,98549607,2000
2005-11-11,2245,Derailed,22000000,57520063,36020063,35520063,2000
2005-11-18,138,Harry Potter and the Goblet of Fire,150000000,896911078,290013036,746911078,2000
2005-11-18,1865,Walk the Line,29000000,187707495,119519402,158707495,2000
2005-11-23,1047,Syriana,50000000,92690959,50824620,42690959,2000
2005-11-23,1189,"Yours, Mine and Ours",45000000,72359917,53359917,27359917,2000
2005-11-23,1375,Rent,40000000,31670620,29077547,-8329380,2000
2005-11-23,2271,The Libertine,22000000,9448623,4835065,-12551377,2000
2005-12-08,873,The Great Raid,60000000,10597070,10166502,-49402930,2000
2005-12-08,1342,The Skeleton Key,40000000,92256918,47907715,52256918,2000
2005-12-08,1733,Four Brothers,30000000,92494381,74494381,62494381,2000
2005-12-08,2252,Deuce Bigalow: European Gigolo,22000000,45273464,22400154,23273464,2000
2005-12-08,3898,11:14,6000000,0,0,-6000000,2000
2005-12-14,35,King Kong,207000000,550517357,218080025,343517357,2000
2005-12-14,2909,Los tres entierros de Melquiades Estrada,15000000,13454474,5027684,-1545526,2000
2005-12-16,1213,The Producers: The Movie Musical,45000000,32952995,19398532,-12047005,2000
2005-12-16,2574,The Family Stone,18000000,92357499,60062868,74357499,2000
2005-12-21,189,Fun With Dick And Jane,140000000,203018919,110550000,63018919,2000
2005-12-21,797,Cheaper by the Dozen 2,60000000,135015330,82571173,75015330,2000
2005-12-21,2770,The White Countess,16000000,2814566,1669971,-13185434,2000
2005-12-23,597,Munich,75000000,131492772,47379090,56492772,2000
2005-12-23,3639,Caché,8000000,19891331,3647381,11891331,2000
2005-12-25,665,Rumor Has It,70000000,88933562,42996140,18933562,2000
2005-12-25,1828,The New World,30000000,26184400,12712093,-3815600,2000
2005-12-25,4825,Wolf Creek,1100000,29005064,16186348,27905064,2000
2005-12-28,2854,Match Point,15000000,87973835,23089926,72973835,2000
2005-12-30,3380,The Matador,10000000,17300838,12589255,7300838,2000
2005-12-31,2944,Dungeons & Dragons: Wrath of the Dragon God,15000000,909822,0,-14090178,2000
2005-12-31,4531,Chicken Tikka Masala,2160000,37865,0,-2122135,2000
2005-12-31,5091,Insomnia Manica,500000,0,0,-500000,2000
2005-12-31,5335,The Call of Cthulhu,50000,0,0,-50000,2000
2006-01-09,3152,Crank,12000000,43924923,27838408,31924923,2000
2006-01-09,3916,Crossover,5600000,7009668,7009668,1409668,2000
2006-01-09,4451,Lage Raho Munna Bhai,2700000,31517561,2217561,28817561,2000
2006-01-09,4511,Idiocracy,2400000,500296,444093,-1899704,2000
2006-01-09,5349,Mutual Appreciation,30000,103509,103509,73509,2000
2006-01-10,4295,The Secret,3500000,0,0,-3500000,2000
2006-01-12,1553,The Nativity Story,35000000,46309644,37629831,11309644,2000
2006-01-12,3400,Turistas,10000000,14321070,7027762,4321070,2000
2006-01-13,1198,Last Holiday,45000000,43343247,38399961,-1656753,2000
2006-01-13,1769,Glory Road,30000000,42799060,42647449,12799060,2000
2006-01-13,2659,Hoodwinked,17500000,109843390,51386611,92343390,2000
2006-01-20,1182,Underworld: Evolution,45000000,113417762,62318875,68417762,2000
2006-01-20,3383,End of the Spear,10000000,11924041,11748661,1924041,2000
2006-01-20,4854,Transamerica,1000000,16553163,9015303,15553163,2000
2006-01-27,1316,Big Momma's House 2,40000000,137047376,70165972,97047376,2000
2006-01-27,2045,Nanny McPhee,25000000,128745578,47279279,103745578,2000
2006-01-27,2957,Manderlay,14200000,543306,74205,-13656694,2000
2006-01-27,3673,Imagine Me & You,7900000,3129471,672243,-4770529,2000
2006-01-27,3943,Rang De Basanti,5300000,29197694,2197694,23897694,2000
2006-01-27,4100,Tristram Shandy: A Cock and Bull Story,4750000,3061763,1253413,-1688237,2000
2006-01-27,4700,Bubble,1600000,145382,145382,-1454618,2000
2006-02-06,989,The Break-Up,52000000,205727307,118703275,153727307,2000
2006-02-06,2923,Banlieue 13,15000000,11599903,1200216,-3400097,2000
2006-02-06,3424,Peaceful Warrior,10000000,3260179,2893666,-6739821,2000
2006-02-06,5369,The Puffy Chair,15000,195254,194523,180254,2000
2006-02-08,5126,Quinceanera,400000,2797199,1692693,2397199,2000
2006-02-17,1305,Eight Below,40000000,120455994,81612565,80455994,2000
2006-02-17,2341,Date Movie,20000000,85146165,48548426,65146165,2000
2006-02-17,4155,Nochnoy dozor,4200000,33913542,1502188,29713542,2000
2006-02-17,4289,Winter Passing,3500000,113783,107492,-3386217,2000
2006-02-24,2466,Doogal,20000000,28058652,7578946,8058652,2000
2006-02-24,2702,Running Scared,17000000,9729088,6855137,-7270912,2000
2006-02-24,3312,Madea's Family Reunion,10000000,63320521,63257940,53320521,2000
2006-02-24,4387,Tsotsi,3000000,11537539,2912606,8537539,2000
2006-03-02,2815,When a Stranger Calls,15000000,67215435,47860214,52215435,2000
2006-03-03,1199,16 Blocks,45000000,65595141,36895141,20595141,2000
2006-03-03,1813,Ultraviolet,30000000,30962112,18522064,962112,2000
2006-03-03,2275,Joyeux Noël,22000000,23134075,1054361,1134075,2000
2006-03-03,3167,Aquamarine,12000000,22978953,18597342,10978953,2000
2006-03-03,4355,Dave Chappelle's Block Party,3000000,12051924,11718595,9051924,2000
2006-03-11,171,Flushed Away,149000000,179357126,64665672,30357126,2000
2006-03-11,2565,Borat,18000000,261443242,128505958,243443242,2000
2006-03-11,3502,Volver,9400000,87226613,12899867,77826613,2000
2006-03-11,4262,Unknown,3700000,3355048,26403,-344952,2000
2006-03-17,1033,V for Vendetta,50000000,130214162,70511035,80214162,2000
2006-03-17,2067,She's the Man,25000000,55279608,33889159,30279608,2000
2006-03-17,3084,Find Me Guilty,13000000,2898225,1173673,-10101775,2000
2006-03-17,3680,Thank You For Smoking,7500000,40016662,24793509,32516662,2000
2006-03-17,4407,Sommersturm,3000000,95204,95204,-2904796,2000
2006-03-17,4748,Fetching Cody,1500000,0,0,-1500000,2000
2006-03-24,1023,Inside Man,50000000,185798265,88634237,135798265,2000
2006-03-24,2395,Stay Alive,20000000,23187506,23086480,3187506,2000
2006-03-24,2694,Larry the Cable Guy: Health Inspector,17000000,15680099,15680099,-1319901,2000
2006-03-24,4437,Boynton Beach Club,2900000,3127472,3127472,227472,2000
2006-03-24,5070,Lonesome Jim,500000,602789,154187,102789,2000
2006-03-31,577,Ice Age: The Meltdown,75000000,651899282,195330621,576899282,2000
2006-03-31,685,Basic Instinct 2,70000000,35417162,5946136,-34582838,2000
2006-03-31,2691,ATL,17000000,21170563,21170563,4170563,2000
2006-03-31,2786,Slither,15250000,12930343,7802450,-2319657,2000
2006-03-31,4490,Marilyn Hotchkiss' Ballroom Dancing and Charm School,2500000,497195,349132,-2002805,2000
2006-03-31,5112,Brick,450000,4243996,2075743,3793996,2000
2006-04-05,4132,Chinjeolhan geumjassi,4500000,23471871,211667,18971871,2000
2006-04-08,618,Talladega Nights: The Ballad of Ricky Bobby,73000000,162870525,148213377,89870525,2000
2006-04-08,998,Barnyard: The Original Party Animals,51000000,118583844,72779000,67583844,2000
2006-04-08,3627,"Bon Cop, Bad Cop",8000000,12740705,12671300,4740705,2000
2006-04-08,3721,The Descent,7000000,57051053,26024456,50051053,2000
2006-04-08,4190,The Night Listener,4000000,10770993,7836393,6770993,2000
2006-04-10,4579,Shortbus,2000000,1985292,1985292,-14708,2000
2006-04-14,538,The Wild,80000000,99010667,37384046,19010667,2000
2006-04-14,1297,Scary Movie 4,40000000,178710620,90710620,138710620,2000
2006-04-14,4951,Hard Candy,950000,8267066,1024640,7317066,2000
2006-04-21,845,The Sentinel,60000000,78080697,36280697,18080697,2000
2006-04-21,1056,Silent Hill,50000000,94704227,46982632,44704227,2000
2006-04-21,2700,American Dreamz,17000000,16510971,7314027,-489029,2000
2006-04-21,4922,In Her Line of Fire,1000000,884,884,-999116,2000
2006-04-28,927,R.V.,55000000,87524497,71724497,32524497,2000
2006-04-28,2383,Stick It,20000000,30399714,26910736,10399714,2000
2006-04-28,2590,United 93,18000000,77635035,31567134,59635035,2000
2006-04-28,3494,The Lost City,9600000,5256839,2484186,-4343161,2000
2006-04-28,3617,Akeelah and the Bee,8000000,18959424,18848430,10959424,2000
2006-04-28,4371,Water,3000000,11322573,5529144,8322573,2000
2006-04-28,5373,Grip: A Criminal's Story,12000,1336,1336,-10664,2000
2006-04-28,5376,Clean,10000,138711,138711,128711,2000
2006-05-05,155,Mission: Impossible III,150000000,397501348,133501348,247501348,2000
2006-05-05,1848,Wu ji,30000000,35869934,669625,5869934,2000
2006-05-05,2491,The Proposition,20000000,5313608,1903434,-14686392,2000
2006-05-05,2901,Hoot,15000000,8224998,8117637,-6775002,2000
2006-05-05,2983,An American Haunting,14000000,30443277,16298046,16443277,2000
2006-05-05,3649,Down in the Valley,8000000,973443,568932,-7026557,2000
2006-05-12,3526,Black Christmas,9000000,16235738,16235738,7235738,2000
2006-05-19,236,The Da Vinci Code,125000000,767820459,217536138,642820459,2000
2006-05-19,493,Over the Hedge,80000000,343397247,155019340,263397247,2000
2006-05-19,3625,See No Evil,8000000,18828036,15032800,10828036,2000
2006-05-23,4159,High School Musical,4200000,0,0,-4200000,2000
2006-05-24,4845,An Inconvenient Truth,1000000,52769915,24146161,51769915,2000
2006-05-26,32,X-Men: The Last Stand,210000000,459359555,234362462,249359555,2000
2006-05-26,5385,Cavite,7000,71644,70071,64644,2000
2006-06-01,2142,BloodRayne,25000000,3605420,2405420,-21394580,2000
2006-06-01,3216,Fateless,12000000,196857,196857,-11803143,2000
2006-06-01,4030,Grandma's Boy,5000000,6590172,6090172,1590172,2000
2006-06-01,4097,Hostel,4800000,82241110,47326473,77441110,2000
2006-06-06,2036,The Omen,25000000,119295584,54607383,94295584,2000
2006-06-10,402,The Departed,90000000,289660619,132384315,199660619,2000
2006-06-10,2734,The Texas Chainsaw Massacre: The Beginning,16000000,50517763,39517763,34517763,2000
2006-06-10,2999,Little Children,14000000,14121177,5463019,121177,2000
2006-06-10,3346,Employee of the Month,10000000,38364855,28444855,28364855,2000
2006-06-10,4400,Love's Abiding Joy,3000000,252726,252726,-2747274,2000
2006-06-16,459,The Fast and the Furious: Tokyo Drift,85000000,157794205,62615510,72794205,2000
2006-06-16,857,Garfield: A Tail of Two Kitties,60000000,147985373,28426747,87985373,2000
2006-06-16,1334,The Lake House,40000000,114830111,52330111,74830111,2000
2006-06-16,1666,Nacho Libre,32000000,99296462,80197993,67296462,2000
2006-06-16,5055,Wordplay,500000,3177636,3121270,2677636,2000
2006-06-23,478,Click,82500000,237685089,137355633,155185089,2000
2006-06-23,3435,Krrish,10000000,32430721,1430721,22430721,2000
2006-06-23,4617,Say Uncle,2000000,5361,5361,-1994639,2000
2006-06-28,19,Superman Returns,232000000,374085065,200120000,142085065,2000
2006-06-28,4578,Strangers with Candy,2000000,2077844,2072645,77844,2000
2006-06-28,4873,Who Killed the Electric Car?,1000000,1849392,1678874,849392,2000
2006-06-28,5200,The Motel,250000,51540,51540,-198460,2000
2006-06-30,1516,The Devil Wears Prada,35000000,326073155,124740460,291073155,2000
2006-06-30,5288,The Blood of My Brother: A Story of Death in Iraq,120000,0,0,-120000,2000
2006-07-04,1535,The Benchwarmers,35000000,65063726,59843754,30063726,2000
2006-07-04,1788,Take the Lead,30000000,65390493,34742066,35390493,2000
2006-07-04,1948,Lucky Number Slevin,27000000,55495466,22495466,28495466,2000
2006-07-04,3808,Friends with Money,6500000,18110152,13368437,11610152,2000
2006-07-04,4367,Phat Girlz,3000000,7301115,7061128,4301115,2000
2006-07-04,4779,Simon,1300000,1738663,4055,438663,2000
2006-07-07,23,Pirates of the Caribbean: Dead Man’s Chest,225000000,1066215812,423315812,841215812,2000
2006-07-07,2476,A Scanner Darkly,20000000,7405084,5501616,-12594916,2000
2006-07-07,4900,Once in a Lifetime: the Extraordinary Story of the New York Cosmos,1000000,215559,144601,-784441,2000
2006-07-14,755,Little Man,64000000,101636047,58636047,37636047,2000
2006-07-14,971,"You, Me and Dupree",54000000,130402010,75802010,76402010,2000
2006-07-14,3460,Edmond,10000000,241719,131719,-9758281,2000
2006-07-14,4054,The Oh in Ohio,5000000,648183,418689,-4351817,2000
2006-07-21,592,Monster House,75000000,141267370,73661010,66267370,2000
2006-07-21,601,Lady in the Water,75000000,72785169,42285169,-2214831,2000
2006-07-21,1804,My Super Ex-Girlfriend,30000000,60772856,22530295,30772856,2000
2006-07-21,3981,Clerks II,5000000,27342246,24148068,22342246,2000
2006-07-21,5246,The Case of the Grinning Cat,200000,7033,7033,-192967,2000
2006-07-26,3600,Little Miss Sunshine,8000000,100642353,59891098,92642353,2000
2006-07-28,208,Miami Vice,135000000,163818556,63478838,28818556,2000
2006-07-28,1202,The Ant Bully,45000000,49610898,28142535,4610898,2000
2006-07-28,4184,Scoop,4000000,40103262,10525717,36103262,2000
2006-08-09,2393,The Covenant,20000000,38164784,23364784,18164784,2000
2006-08-09,3911,Tom yum goong,5700000,43044087,12044087,37344087,2000
2006-08-09,4596,Sherrybaby,2000000,759504,199176,-1240496,2000
2006-08-09,4995,Iraq for Sale: The War Profiteers,775000,0,0,-775000,2000
2006-08-12,351,Blood Diamond,100000000,171377916,57377916,71377916,2000
2006-08-12,458,The Holiday,85000000,205190324,63280000,120190324,2000
2006-08-12,1338,Apocalypto,40000000,121032272,50866635,81032272,2000
2006-08-12,2099,Unaccompanied Minors,25000000,21970831,16655224,-3029169,2000
2006-08-18,1648,Snakes on a Plane,33000000,62020814,34020814,29020814,2000
2006-08-18,2719,The Illusionist,16500000,83792062,39868642,67292062,2000
2006-08-18,3543,Trust the Man,9000000,2548378,1530535,-6451622,2000
2006-08-18,3660,10th & Wolf,8000000,143782,54702,-7856218,2000
2006-08-25,1327,Invincible,40000000,58501127,57806952,18501127,2000
2006-08-25,2662,Beerfest,17500000,20159316,19185184,2659316,2000
2006-08-25,2881,Idlewild,15000000,12669914,12669914,-2330086,2000
2006-08-25,4964,The Quiet,900000,381420,381420,-518580,2000
2006-08-25,5163,Old Joy,300000,399908,255923,99908,2000
2006-09-06,636,Cars,70000000,461651246,244082982,391651246,2000
2006-09-06,3359,A Prairie Home Companion,10000000,26716191,20342852,16716191,2000
2006-09-08,727,World Trade Center,65000000,163295654,70278893,98295654,2000
2006-09-15,863,The Black Dahlia,60000000,49238525,22672813,-10761475,2000
2006-09-15,1780,Gridiron Gang,30000000,41457834,38432823,11457834,2000
2006-09-15,4446,Artie Lange's Beer League,2800000,475000,475000,-2325000,2000
2006-09-15,4929,Jimmy and Judy,1000000,0,0,-1000000,2000
2006-09-22,869,Flyboys,60000000,14816379,13090630,-45183621,2000
2006-09-22,963,All the King's Men,55000000,9521458,7221458,-45478542,2000
2006-09-22,1629,Bandidas,35000000,19282590,0,-15717410,2000
2006-09-22,2647,Renaissance,18000000,2401413,70644,-15598587,2000
2006-09-22,3245,Jackass: Number Two,11000000,85278712,72778712,74278712,2000
2006-09-22,3867,La science des rêves,6000000,15137932,4670644,9137932,2000
2006-09-22,4326,Feast,3200000,690872,56131,-2509128,2000
2006-09-27,3847,The Last King of Scotland,6000000,49155371,17606684,43155371,2000
2006-09-29,454,Open Season,85000000,191932158,85105259,106932158,2000
2006-09-29,661,The Guardian,70000000,94973540,55011732,24973540,2000
2006-09-29,2414,School for Scoundrels,20000000,17807569,17807569,-2192431,2000
2006-09-29,5296,Facing the Giants,100000,10243159,10178331,10143159,2000
2006-09-30,2810,The Queen,15000000,128885873,56441711,113885873,2000
2006-10-02,517,The Pink Panther,80000000,158926474,82226474,78926474,2000
2006-10-02,1040,Curious George,50000000,71052604,58640119,21052604,2000
2006-10-02,1051,Firewall,50000000,82751189,48751189,32751189,2000
2006-10-02,2037,Final Destination 3,25000000,112798051,54098051,87798051,2000
2006-10-02,4613,London,2000000,12667,12667,-1987333,2000
2006-10-03,813,The Shaggy Dog,60000000,87123569,61123569,27123569,2000
2006-10-03,1022,Failure to Launch,50000000,128402901,88715192,78402901,2000
2006-10-03,2681,The Hills Have Eyes,17000000,70355813,41778863,53355813,2000
2006-10-11,1614,A Good Year,35000000,42064105,7459300,7064105,2000
2006-10-11,1775,Stranger Than Fiction,30000000,53572822,40435190,23572822,2000
2006-10-11,2715,FUR: An Imaginary Portrait of Diane Arbus,16800000,2281089,223202,-14518911,2000
2006-10-11,3280,Copying Beethoven,11000000,6586324,355968,-4413676,2000
2006-10-11,3889,Come Early Morning,6000000,119452,119452,-5880548,2000
2006-10-11,4573,Harsh Times,2000000,6225304,3337931,4225304,2000
2006-10-13,1427,Alex Rider: Operation Stormbreaker,40000000,20722450,659210,-19277550,2000
2006-10-13,2353,The Grudge 2,20000000,70743839,39143839,50743839,2000
2006-10-13,2358,Man of the Year,20000000,41342180,37442180,21342180,2000
2006-10-13,2436,One Night with the King,20000000,13725032,13395961,-6274968,2000
2006-10-13,2864,The Marine,15000000,22165608,18844784,7165608,2000
2006-10-13,3086,Infamous,13000000,2613717,1151330,-10386283,2000
2006-10-13,4103,Driving Lessons,4700000,239962,239962,-4460038,2000
2006-10-18,5148,51 Birch Street,350000,84689,84689,-265311,2000
2006-10-20,983,Flags of Our Fathers,53000000,63657941,33602376,10657941,2000
2006-10-20,1333,The Prestige,40000000,104407366,53089891,64407366,2000
2006-10-20,1396,Marie Antoinette,40000000,60862471,15962471,20862471,2000
2006-10-20,2859,Flicka,15000000,21896367,21000147,6896367,2000
2006-10-20,3187,Running With Scissors,12000000,8706701,6860000,-3293299,2000
2006-10-27,2367,Babel,20000000,132121212,34302837,112121212,2000
2006-10-27,3003,Catch a Fire,14000000,5782198,4299773,-8217802,2000
2006-10-27,3307,Saw III,10000000,163876815,80238724,153876815,2000
2006-11-08,1602,Zoom,35000000,12506188,11989328,-22493812,2000
2006-11-08,2305,Pulse,20500000,30241435,20264436,9741435,2000
2006-11-08,3133,Step Up,12000000,110989157,65328121,98989157,2000
2006-11-08,3289,Kabhi Alvida Naa Kehna,10750000,32575443,3275443,21825443,2000
2006-11-08,4256,Casa de Areia,3750000,1178175,539285,-2571825,2000
2006-11-08,5012,Half Nelson,700000,4911725,2697938,4211725,2000
2006-11-08,5114,Conversations with Other Women,450000,1297745,379418,847745,2000
2006-11-17,323,Casino Royale,102000000,594420283,167365000,492420283,2000
2006-11-17,440,Happy Feet,85000000,385000317,198000317,300000317,2000
2006-11-17,2994,Bobby,14000000,20597806,11242801,6597806,2000
2006-11-17,3190,For Your Consideration,12000000,5549923,5549923,-6450077,2000
2006-11-17,4196,Let's Go to Prison,4000000,4630045,4630045,630045,2000
2006-11-21,4261,The History Boys,3700000,13447998,2730296,9747998,2000
2006-11-22,526,Déjà Vu,80000000,181038616,64038616,101038616,2000
2006-11-22,999,Deck the Halls,51000000,46815807,35093569,-4184193,2000
2006-11-22,1609,The Fountain,35000000,15461638,10144010,-19538362,2000
2006-11-22,3555,Opal Dreams,9000000,14443,14443,-8985557,2000
2006-11-24,3592,Kurtlar vadisi - Irak,8300000,24906717,0,16606717,2000
2006-12-04,5168,Sisters in Law,300000,33312,33312,-266688,2000
2006-12-05,124,Poseidon,160000000,181674817,60674817,21674817,2000
2006-12-05,1654,Goal! The Dream Begins,33000000,27610873,4283255,-5389127,2000
2006-12-05,1916,Just My Luck,28000000,38159905,17326650,10159905,2000
2006-12-05,3773,Wah-Wah,7000000,463039,234750,-6536961,2000
2006-12-05,4037,Keeping Up with the Steins,5000000,4414753,4339241,-585247,2000
2006-12-05,4824,Dead Man's Shoes,1125000,414736,6408,-710264,2000
2006-12-15,345,Eragon,100000000,249488115,75030163,149488115,2000
2006-12-15,479,Charlotte's Web,82500000,143985708,82985708,61485708,2000
2006-12-15,587,Dreamgirls,75000000,155708695,103365956,80708695,2000
2006-12-15,910,The Pursuit of Happyness,55000000,307325633,162586036,252325633,2000
2006-12-15,1689,The Good German,32000000,1308696,1308696,-30691304,2000
2006-12-15,2557,Indigènes,18900000,26063572,320700,7163572,2000
2006-12-20,2167,Rocky Balboa,24000000,156229050,70269899,132229050,2000
2006-12-20,2524,The Painted Veil,19400000,15118795,8060487,-4281205,2000
2006-12-20,3066,Letters from Iwo Jima,13000000,67867998,13756082,54867998,2000
2006-12-21,1226,Man cheng jin dai huang jin jia,45000000,76904429,6566773,31904429,2000
2006-12-21,3872,Venus,6000000,7818479,3347411,1818479,2000
2006-12-22,283,Night at the Museum,110000000,579446407,250863268,469446407,2000
2006-12-22,736,We Are Marshall,65000000,43545364,43545364,-21454636,2000
2006-12-25,570,Children of Men,76000000,69845011,35552383,-6154989,2000
2006-12-25,1934,Notes on a Scandal,27500000,50578411,17510118,23078411,2000
2006-12-27,757,Perfume: The Story of a Murderer,63700000,133603463,2223293,69903463,2000
2006-12-29,1847,Miss Potter,30000000,35891257,3005605,5891257,2000
2006-12-29,2735,El Laberinto del Fauno,16000000,87041569,37634615,71041569,2000
2006-12-29,4315,The Dead Girl,3300000,19875,19875,-3280125,2000
2006-12-31,1270,Les Bronzés 3: amis pour la vie,42000000,83833602,0,41833602,2000
2006-12-31,1964,The Magic Flute,27000000,0,0,-27000000,2000
2006-12-31,4926,Loving Annabelle,1000000,5382,0,-994618,2000
2006-12-31,5085,Fengkuang de Shitou,500000,3000000,0,2500000,2000
2007-01-06,1928,Knocked Up,27500000,219265952,148761765,191765952,2000
2007-01-06,3541,Gracie,9000000,3922043,2956339,-5077957,2000
2007-01-06,4950,And Then Came Love,989000,8158,8158,-980842,2000
2007-01-17,4915,Alone with Her,1000000,844377,10787,-155623,2000
2007-01-26,2351,Epic Movie,20000000,86858578,39739367,66858578,2000
2007-01-26,2684,Smokin' Aces,17000000,57263440,35662731,40263440,2000
2007-01-26,2915,Blood and Chocolate,15000000,6551310,3526588,-8448690,2000
2007-01-30,4078,Farce of the Penguins,5000000,0,0,-5000000,2000
2007-02-02,1438,Because I Said So,39000000,69538833,42674040,30538833,2000
2007-02-02,2737,The Messengers,16000000,53774833,35374833,37774833,2000
2007-02-02,3486,Partition,10000000,0,0,-10000000,2000
2007-02-02,3760,Factory Girl,7000000,1661464,1661464,-5338536,2000
2007-02-03,471,Zodiac,85000000,83080084,33080084,-1919916,2000
2007-02-03,776,Wild Hogs,60000000,253555383,168213584,193555383,2000
2007-02-03,2892,Black Snake Moan,15000000,10951153,9396870,-4048847,2000
2007-02-05,4709,Waitress,1500000,22217183,19097550,20717183,2000
2007-02-07,133,Transformers,151000000,708272592,319246193,557272592,2000
2007-02-11,159,Bee Movie,150000000,287594577,126631277,137594577,2000
2007-02-11,334,American Gangster,100000000,267985456,130164645,167985456,2000
2007-02-11,1958,The Martian Child,27000000,9352089,7500310,-17647911,2000
2007-02-14,1339,Music and Lyrics,40000000,146300356,50572589,106300356,2000
2007-02-16,259,Ghost Rider,120000000,229545589,115802596,109545589,2000
2007-02-16,2020,Bridge to Terabithia,25000000,137984788,82234139,112984788,2000
2007-02-23,1675,The Number 23,32000000,77593167,35193167,45593167,2000
2007-02-23,3068,The Astronaut Farmer,13000000,11141213,11003643,-1858787,2000
2007-02-23,3360,Reno 911!: Miami,10000000,21851362,20342161,11851362,2000
2007-03-07,1547,License to Wed,35000000,70187088,43799818,35187088,2000
2007-03-08,213,The Bourne Ultimatum,130000000,442161562,227471070,312161562,2000
2007-03-08,2112,Hot Rod,25000000,14334401,13938332,-10665599,2000
2007-03-08,2720,Becoming Jane,16500000,39380876,18663911,22880876,2000
2007-03-08,3947,The Ten,5250000,786677,769726,-4463323,2000
2007-03-08,4059,"Gandhi, My Father",5000000,1375194,240425,-3624806,2000
2007-03-10,3896,Lake of Fire,6000000,26007,25317,-5973993,2000
2007-03-13,4675,Sublime,1800000,0,0,-1800000,2000
2007-03-16,1431,Nomad,40000000,79123,79123,-39920877,2000
2007-03-16,2344,Premonition,20000000,81461343,47852604,61461343,2000
2007-03-16,2992,I Think I Love My Wife,14000000,13205411,12559771,-794589,2000
2007-03-16,3590,The Wind That Shakes the Barley,8300000,25670174,1829142,17370174,2000
2007-03-23,831,Shooter,60000000,95538560,47003582,35538560,2000
2007-03-23,1540,TMNT,35000000,96096018,54149098,61096018,2000
2007-03-23,2406,Reign Over Me,20000000,20081987,19661987,81987,2000
2007-03-23,2860,The Hills Have Eyes II,15000000,37466538,20804166,22466538,2000
2007-03-23,3587,Namastey London,8400000,6831069,1207007,-1568931,2000
2007-03-23,4772,Journey from the Fall,1300000,635305,635305,-664695,2000
2007-03-30,769,Blades of Glory,61000000,145594548,118594548,84594548,2000
2007-04-05,9,Spider-Man 3,258000000,890875303,336530303,632875303,2000
2007-04-05,966,Lucky You,55000000,6521829,5755286,-48478171,2000
2007-04-05,3076,"Paris, je t'aime",13000000,5175088,4857374,-7824912,2000
2007-04-07,3411,Rescue Dawn,10000000,7037886,5490423,-2962114,2000
2007-04-09,3666,The Death and Life of Bobby Z,8000000,414617,0,-7585383,2000
2007-04-13,2324,Disturbia,20000000,118537627,80818974,98537627,2000
2007-04-13,2782,Slow Burn,15500000,1237615,1237615,-14262385,2000
2007-04-13,4997,Aqua Teen Hunger Force Colon Movie Film for Theaters,750000,5520368,5520368,4770368,2000
2007-04-20,2743,Hot Fuzz,16000000,81742618,23618786,65742618,2000
2007-04-20,3296,In the Land of Women,10500000,14140402,11052958,3640402,2000
2007-04-27,3288,Jindabyne,10800000,2862544,399879,-7937456,2000
2007-04-27,3700,Ta Ra Rum Pum,7400000,9443864,872643,2043864,2000
2007-05-01,1147,Happily N'Ever After,47000000,37923818,15849032,-9076182,2000
2007-05-01,2291,Freedom Writers,21000000,43632609,36605602,22632609,2000
2007-05-01,2461,Code Name: The Cleaner,20000000,8135024,8135024,-11864976,2000
2007-05-01,4510,Thr3e,2400000,1420418,1008849,-979582,2000
2007-05-04,1382,The Reaping,40000000,62226214,25126214,22226214,2000
2007-05-09,4734,I Want Someone To Eat Cheese With,1500000,194568,194568,-1305432,2000
2007-05-10,2280,Michael Clayton,21500000,92987651,49033882,71487651,2000
2007-05-10,2939,The Good Night,15000000,22441,22441,-14977559,2000
2007-05-10,5075,Finishing the Game,500000,53201,52850,-446799,2000
2007-05-12,3708,Juno,7000000,231450102,143495265,224450102,2000
2007-05-16,5271,Once,150000,23344056,9445857,23194056,2000
2007-05-17,116,Shrek the Third,160000000,807330936,322719944,647330936,2000
2007-05-18,3459,Severance,10000000,5950002,137221,-4049998,2000
2007-05-18,3655,The Wendell Baker Story,8000000,127188,127188,-7872812,2000
2007-05-24,3,Pirates of the Caribbean: At World’s End,300000000,963420425,309420425,663420425,2000
2007-05-25,4193,Bug,4000000,8302995,7006708,4302995,2000
2007-06-04,984,Grindhouse,53000000,50187789,25031037,-2812211,2000
2007-06-04,2132,The Hoax,25000000,7164995,7164995,-17835005,2000
2007-06-04,2272,Zwartboek,22000000,27238354,4398532,5238354,2000
2007-06-15,257,Fantastic Four: Rise of the Silver Surfer,120000000,288215319,131921738,168215319,2000
2007-06-15,1850,DOA: Dead or Alive,30000000,7755686,480314,-22244314,2000
2007-06-15,2390,Nancy Drew,20000000,30703845,25584685,10703845,2000
2007-06-15,3652,Fido,8000000,456814,298110,-7543186,2000
2007-06-15,5165,Pierrot le fou,300000,70807,70807,-229193,2000
2007-06-15,5249,The Trials of Darryl Hunt,200000,1217,1217,-198783,2000
2007-06-22,92,Evan Almighty,175000000,174131329,100289690,-868671,2000
2007-06-22,2228,1408,22500000,131263370,71985628,108763370,2000
2007-06-22,2895,A Mighty Heart,15000000,19153568,9176787,4153568,2000
2007-06-22,3520,Sicko,9000000,36535837,24538513,27535837,2000
2007-06-22,4204,You Kill Me,4000000,3858964,2426851,-141036,2000
2007-06-27,287,Live Free or Die Hard,110000000,382288147,134529403,272288147,2000
2007-06-29,144,Ratatouille,150000000,626549695,206445654,476549695,2000
2007-06-29,4657,Chacun sa nuit,1900000,139317,18435,-1760683,2000
2007-07-07,4629,Rockaway,2000000,0,0,-2000000,2000
2007-07-09,1134,3:10 to Yuma,48000000,71171825,53606916,23171825,2000
2007-07-09,1426,The Hunting Party,40000000,7729552,876671,-32270448,2000
2007-07-09,3279,Romance and Cigarettes,11000000,3231251,551002,-7768749,2000
2007-07-09,3441,The Brothers Solomon,10000000,900926,900926,-9099074,2000
2007-07-09,4586,In the Shadow of the Moon,2000000,1134358,1134358,-865642,2000
2007-07-09,4736,Hatchet,1500000,240396,175281,-1259604,2000
2007-07-12,36,The Golden Compass,205000000,367262558,70107728,162262558,2000
2007-07-12,1761,Atonement,30000000,129779728,50980159,99779728,2000
2007-07-12,4465,Timber Falls,2600000,71248,0,-2528752,2000
2007-07-18,4985,Cama adentro,800000,200433,200433,-599567,2000
2007-07-20,450,I Now Pronounce You Chuck and Larry,85000000,185708462,119725280,100708462,2000
2007-07-20,585,Hairspray,75000000,203035572,118871849,128035572,2000
2007-07-20,1421,Sunshine,40000000,32030610,3688560,-7969390,2000
2007-07-25,4514,This is England,2380000,8739576,327919,6359576,2000
2007-07-27,622,The Simpsons Movie,72500000,527071022,183135014,454571022,2000
2007-07-27,1903,No Reservations,28000000,91943956,43107979,63943956,2000
2007-07-27,2279,Molière,21600000,791154,635733,-20808846,2000
2007-07-27,3748,Who's Your Caddy?,7000000,5694308,5694308,-1305692,2000
2007-07-27,4584,No End In Sight,2000000,1433319,1433319,-566681,2000
2007-08-06,350,Surf's Up,100000000,145395745,58867694,45395745,2000
2007-08-06,451,Ocean's Thirteen,85000000,311744465,117144465,226744465,2000
2007-08-06,2780,La Môme,15500000,88611837,10299782,73111837,2000
2007-08-06,3681,Hostel: Part II,7500000,33606409,17544812,26106409,2000
2007-08-08,3850,Daddy Day Camp,6000000,18209872,13235267,12209872,2000
2007-08-17,553,The Invasion,80000000,40147042,15074191,-39852958,2000
2007-08-17,702,The Last Legion,67000000,25357771,5932060,-41642229,2000
2007-08-17,2459,Death at a Funeral,20000000,46790428,8580428,26790428,2000
2007-08-17,2656,Superbad,17500000,169955142,121463226,152455142,2000
2007-08-24,2069,Mr. Bean’s Holiday,25000000,234981342,33302167,209981342,2000
2007-08-24,2087,War,25000000,40686409,22486409,15686409,2000
2007-08-24,3077,Resurrecting the Champ,13000000,3260555,3172382,-9739445,2000
2007-08-24,3302,September Dawn,10100000,1066555,1066555,-9033445,2000
2007-08-24,4497,Eye of the Dolphin,2500000,72260,72210,-2427740,2000
2007-08-31,2453,Death Sentence,20000000,16907831,9534258,-3092169,2000
2007-08-31,2809,Halloween,15000000,77514401,58269151,62514401,2000
2007-08-31,4138,Fong juk,4500000,51957,51957,-4448043,2000
2007-09-02,1080,Hannibal Rising,50000000,80583311,27669725,30583311,2000
2007-09-02,4528,The Last Sin Eater,2200000,388390,388390,-1811610,2000
2007-09-02,4554,Das Leben der Anderen,2000000,81197047,11284657,79197047,2000
2007-09-03,775,300,60000000,454161935,210614939,394161935,2000
2007-09-03,3200,Gwoemul,12000000,92618117,2201923,80618117,2000
2007-09-03,3539,The Ultimate Gift,9000000,3438735,3438735,-5561265,2000
2007-09-03,3578,The Namesake,8500000,20288774,13610521,11788774,2000
2007-09-11,1598,Lions for Lambs,35000000,63211088,14998070,28211088,2000
2007-09-11,2027,No Country for Old Men,25000000,164051250,74273505,139051250,2000
2007-09-11,4404,Holly,3000000,163069,163069,-2836931,2000
2007-09-14,1101,Eastern Promises,50000000,56077088,17181265,6077088,2000
2007-09-14,1206,Across the Universe,45000000,29367143,24343673,-15632857,2000
2007-09-14,1685,D-War,32000000,79915361,10977721,47915361,2000
2007-09-14,2220,In the Valley of Elah,23000000,24489150,6777741,1489150,2000
2007-09-14,3449,King of California,10000000,1165102,268461,-8834898,2000
2007-09-14,4287,Ira and Abby,3500000,221096,221096,-3278904,2000
2007-09-21,1192,Resident Evil: Extinction,45000000,146162920,50648679,101162920,2000
2007-09-21,1843,The Assassination of Jesse James by the Coward Robert Ford,30000000,15313631,3909149,-14686369,2000
2007-09-21,2065,Good Luck Chuck,25000000,59183821,35017297,34183821,2000
2007-09-21,2411,Into the Wild,20000000,56822960,18354356,36822960,2000
2007-09-21,2722,Sydney White,16500000,13636339,11892415,-2863661,2000
2007-09-28,625,The Kingdom,72500000,86509602,47467250,14009602,2000
2007-09-28,2234,The Game Plan,22000000,146590987,90648202,124590987,2000
2007-09-28,2911,Se jie,15000000,65261291,4604982,50261291,2000
2007-09-28,3215,Trade,12000000,1513388,214202,-10486612,2000
2007-10-08,76,Rush Hour 3,180000000,256585882,140125968,76585882,2000
2007-10-08,667,Stardust,70000000,137022245,38634938,67022245,2000
2007-10-10,3822,Control,6400000,8902141,871577,2502141,2000
2007-10-19,1778,30 Days of Night,30000000,80276156,39568996,50276156,2000
2007-10-19,1935,Rendition,27500000,26939925,9736045,-560075,2000
2007-10-19,2544,"Gone, Baby, Gone",19000000,34352162,20300218,15352162,2000
2007-10-19,2765,Things We Lost in the Fire,16000000,8120148,3287315,-7879852,2000
2007-10-19,3440,The Ten Commandments,10000000,1051907,952820,-8948093,2000
2007-10-19,4112,Out of the Blue,4600000,731767,728,-3868233,2000
2007-10-19,4891,Wristcutters: A Love Story,1000000,473769,446165,-526231,2000
2007-10-19,5032,Arnolds Park,600000,23616,23616,-576384,2000
2007-10-19,5250,The Man From Earth,200000,0,0,-200000,2000
2007-10-26,3311,Saw IV,10000000,135759694,63300095,125759694,2000
2007-10-26,4312,Bella,3300000,12405473,8093373,9105473,2000
2007-11-05,2408,Georgia Rule,20000000,20819601,18882880,819601,2000
2007-11-05,2846,28 Weeks Later,15000000,64232714,28638916,49232714,2000
2007-11-05,3650,Brooklyn Rules,8000000,458232,458232,-7541768,2000
2007-11-05,4739,The Salon,1500000,139084,139084,-1360916,2000
2007-11-07,137,Harry Potter and the Order of the Phoenix,150000000,942943935,292004738,792943935,2000
2007-11-12,3784,High School Musical 2,7000000,0,0,-7000000,2000
2007-11-14,2710,Southland Tales,17000000,364607,275380,-16635393,2000
2007-11-16,164,Beowulf,150000000,194995215,82195215,44995215,2000
2007-11-16,1227,Love in the Time of Cholera,45000000,31077418,4617608,-13922582,2000
2007-11-16,4068,Redacted,5000000,861325,65388,-4138675,2000
2007-11-21,448,Enchanted,85000000,340384141,127706877,255384141,2000
2007-11-21,2072,August Rush,25000000,66015869,31664162,41015869,2000
2007-11-21,2483,I'm Not There,20000000,12397613,4017609,-7602387,2000
2007-11-21,2660,Hitman,17500000,99135571,39687694,81635571,2000
2007-11-21,3042,This Christmas,13000000,49733545,49121934,36733545,2000
2007-11-21,3056,The Mist,13000000,57189408,25593755,44189408,2000
2007-11-28,3533,The Savages,9000000,10642023,6623082,1642023,2000
2007-11-30,2998,Le Scaphandre et le Papillon,14000000,22754472,5990075,8754472,2000
2007-11-30,3566,Awake,8600000,32968648,14373825,24368648,2000
2007-11-30,3667,Maurice Richard,8000000,0,0,-8000000,2000
2007-12-01,552,Arthur et les Minimoys,80000000,113325743,15132763,33325743,2000
2007-12-01,2965,Stomp the Yard,14000000,75525718,61356221,61525718,2000
2007-12-10,958,Elizabeth: The Golden Age,55000000,74870866,16285240,19870866,2000
2007-12-10,1912,We Own the Night,28000000,55307857,28563179,27307857,2000
2007-12-10,2811,Why Did I Get Married?,15000000,55934178,55204525,40934178,2000
2007-12-10,3108,Lars and the Real Girl,12500000,11277119,5956480,-1222881,2000
2007-12-14,140,I am Legend,150000000,585532684,256393010,435532684,2000
2007-12-14,907,Alvin and the Chipmunks,55000000,362605033,217326974,307605033,2000
2007-12-14,1858,Goodbye Bafana,30000000,2717302,0,-27282698,2000
2007-12-14,2422,The Kite Runner,20000000,74180745,15800078,54180745,2000
2007-12-14,5202,Shotgun Stories,250000,284174,46026,34174,2000
2007-12-21,594,Charlie Wilson's War,75000000,119512771,66661095,44512771,2000
2007-12-21,1591,Walk Hard: The Dewey Cox Story,35000000,20606053,18317151,-14393947,2000
2007-12-21,1752,P.S. I Love You,30000000,155769678,53695808,125769678,2000
2007-12-21,3473,Blonde Ambition,10000000,1537479,6422,-8462521,2000
2007-12-25,1168,The Bucket List,45000000,174810815,93466502,129810815,2000
2007-12-25,1351,Aliens vs. Predator - Requiem,40000000,128884494,41797066,88884494,2000
2007-12-25,1352,The Water Horse: Legend of the Deep,40000000,103429755,40412817,63429755,2000
2007-12-25,2515,Butterfly on a Wheel,20000000,0,0,-20000000,2000
2007-12-25,2841,The Great Debaters,15000000,30261293,30226144,15261293,2000
2007-12-25,3702,Persepolis,7300000,25397460,4443403,18097460,2000
2007-12-26,2054,There Will Be Blood,25000000,77208711,40222514,52208711,2000
2007-12-28,4192,El orfanato,4000000,79250193,7159147,75250193,2000
2007-12-31,1927,Alatriste,28000000,22860477,0,-5139523,2000
2007-12-31,2516,Ramanujan,20000000,0,0,-20000000,2000
2007-12-31,2665,Taxi 4,17500000,60865364,0,43365364,2000
2007-12-31,2723,Arn - Tempelriddaren,16500000,21404122,0,4904122,2000
2007-12-31,4640,Slacker Uprising,2000000,0,0,-2000000,2000
2007-12-31,5289,A Dog's Breakfast,120000,0,0,-120000,2000
2007-12-31,5290,A Dog's Breakfast,120000,0,0,-120000,2000
2007-12-31,5374,Tin Can Man,12000,0,0,-12000,2000
2008-01-02,2470,Strange Wilderness,20000000,6947084,6575282,-13052916,2000
2008-01-02,3148,The Eye,12000000,57577765,31418697,45577765,2000
2008-01-02,3397,Over Her Dead Body,10000000,21596074,7570127,11596074,2000
2008-01-02,3801,Hannah Montana/Miley Cyrus: Best of Both Worlds Concert Tour,6500000,70712099,65281781,64212099,2000
2008-01-02,4698,Sukkar banat,1600000,14253760,1060591,12653760,2000
2008-01-07,142,Hancock,150000000,624234272,227946274,474234272,2000
2008-01-08,91,The Mummy: Tomb of the Dragon Emperor,175000000,405760225,102491776,230760225,2000
2008-01-08,2297,Swing Vote,21000000,17589867,16289867,-3410133,2000
2008-01-08,2935,Midnight Meat Train,15000000,1590246,73548,-13409754,2000
2008-01-08,4869,Frozen River,1000000,6030129,2511476,5030129,2000
2008-01-10,4476,Religulous,2500000,13881317,13011160,11381317,2000
2008-01-17,5252,Yesterday Was a Lie,200000,0,0,-200000,2000
2008-01-18,1730,27 Dresses,30000000,160247805,76808654,130247805,2000
2008-01-18,2022,Cloverfield,25000000,171302226,80048433,146302226,2000
2008-01-18,2254,Mad Money,22000000,25044057,20668843,3044057,2000
2008-01-18,4095,All Hat,4900000,15198,15198,-4884802,2000
2008-01-18,4594,Teeth,2000000,2350641,347578,350641,2000
2008-01-18,4896,Taxi to the Dark Side,1000000,304472,274661,-695528,2000
2008-01-23,2878,U2 3D,15000000,26170402,12898847,11170402,2000
2008-01-25,1140,Rambo,47500000,112214531,42754105,64714531,2000
2008-01-25,1570,Untraceable,35000000,52649951,28687835,17649951,2000
2008-01-25,1782,Meet the Spartans,30000000,84646831,38233676,54646831,2000
2008-01-25,2701,How She Move,17000000,8607815,7070641,-8392185,2000
2008-01-25,4962,"4 luni, 3 saptamani si 2 zile",900000,11993156,1196321,11093156,2000
2008-02-05,66,Iron Man,186000000,584604126,318604126,398604126,2000
2008-02-05,1344,Made of Honor,40000000,106548738,46012734,66548738,2000
2008-02-05,3754,Redbelt,7000000,2667084,2344847,-4332916,2000
2008-02-05,4580,Son of Rambow: A Home Movie,2000000,11263263,1785505,9263263,2000
2008-02-14,389,The Spiderwick Chronicles,92500000,162839667,71195053,70339667,2000
2008-02-14,480,Jumper,82500000,223636949,81168265,141136949,2000
2008-02-14,2658,Step Up 2 the Streets,17500000,148586910,58017783,131086910,2000
2008-02-14,3717,"Definitely, Maybe",7000000,55617866,32241649,48617866,2000
2008-02-15,3860,Dolphins and Whales Tribes of the Ocean 3D,6000000,17252287,7714996,11252287,2000
2008-02-15,4448,Diary of the Dead,2750000,5394447,952620,2644447,2000
2008-02-22,1312,Vantage Point,40000000,150886329,72266306,110886329,2000
2008-02-22,2447,Be Kind Rewind,20000000,30894247,11175164,10894247,2000
2008-02-22,3196,Charlie Bartlett,12000000,5295909,3950294,-6704091,2000
2008-02-22,3688,Witless Protection,7500000,4151836,4151836,-3348164,2000
2008-02-22,3824,Die Fälscher,6250000,20199663,5488570,13949663,2000
2008-02-22,5332,The Signal,50000,406299,251150,356299,2000
2008-02-29,952,Semi-Pro,55000000,43980363,33479698,-11019637,2000
2008-02-29,1380,The Other Boleyn Girl,40000000,78269970,26814957,38269970,2000
2008-03-07,3877,The Wackness,6000000,3330012,2077046,-2669988,2000
2008-03-10,1926,How to Lose Friends & Alienate People,28000000,12031443,2775593,-15968557,2000
2008-03-10,2140,Blindness,25000000,20052958,3073392,-4947042,2000
2008-03-10,2319,Beverly Hills Chihuahua,20000000,154218168,94514402,134218168,2000
2008-03-10,2468,An American Carol,20000000,7022183,7013191,-12977817,2000
2008-03-10,2482,Flash of Genius,20000000,4504111,4442377,-15495889,2000
2008-03-10,3176,Rachel Getting Married,12000000,17475475,12796861,5475475,2000
2008-03-10,3335,Nick and Norah's Infinite Playlist,10000000,33886017,31487293,23886017,2000
2008-03-14,445,Horton Hears a Who,85000000,299477886,154529439,214477886,2000
2008-03-14,1652,Doomsday,33000000,21621188,11008770,-11378812,2000
2008-03-14,2293,Never Back Down,21000000,39319801,24850922,18319801,2000
2008-03-14,2922,Funny Games,15000000,8200127,1294640,-6799873,2000
2008-03-19,4685,La misma luna,1700000,23271741,12590147,21571741,2000
2008-03-21,1366,Drillbit Taylor,40000000,49686263,32862104,9686263,2000
2008-03-21,2349,Meet the Browns,20000000,41975388,41975388,21975388,2000
2008-03-21,3611,Shutter,8000000,47782426,25928550,39782426,2000
2008-03-21,4406,The Grand,3000000,115879,115879,-2884121,2000
2008-03-21,4972,The Hammer,850000,442638,442638,-407362,2000
2008-03-28,1522,21,35000000,159846429,81159365,124846429,2000
2008-03-28,1574,Superhero Movie,35000000,73026302,26638520,38026302,2000
2008-03-28,2123,Stop-Loss,25000000,11229035,10915744,-13770965,2000
2008-03-28,3408,"Run, Fatboy, Run",10000000,33512260,6003262,23512260,2000
2008-03-28,5198,Happy Valley,250000,67665,67665,-182335,2000
2008-04-01,2384,One Missed Call,20000000,44513466,26890041,24513466,2000
2008-04-04,890,Leatherheads,58000000,41348628,31373938,-16651372,2000
2008-04-04,1482,Nim's Island,37000000,101857425,48006762,64857425,2000
2008-04-04,2097,The Ruins,25000000,22910563,17432844,-2089437,2000
2008-04-04,3442,My Blueberry Nights,10000000,22198996,866778,12198996,2000
2008-04-04,4860,Shine a Light,1000000,16173879,5505267,15173879,2000
2008-04-07,280,Astérix aux Jeux Olympiques,113500000,132999811,999811,19499811,2000
2008-04-07,2562,Ne le dis à personne,18500000,33954018,6198883,15454018,2000
2008-04-15,4416,à L'Intérieur,3000000,895932,0,-2104068,2000
2008-04-18,939,The Forbidden Kingdom,55000000,129075270,52075270,74075270,2000
2008-04-18,1742,Forgetting Sarah Marshall,30000000,105173042,63172463,75173042,2000
2008-04-18,1820,88 Minutes,30000000,32955399,16930884,2955399,2000
2008-04-18,3213,Life Before Her Eyes,12000000,7203439,303439,-4796561,2000
2008-04-18,3657,Pathology,8000000,3270974,109045,-4729026,2000
2008-04-18,5076,Kiss the Bride,500000,32033,32033,-467967,2000
2008-04-25,1745,Baby Mama,30000000,64170447,60494212,34170447,2000
2008-04-25,2137,Deception,25000000,12850033,4598506,-12149967,2000
2008-04-25,2224,Rogue,23000000,4673377,10452,-18326623,2000
2008-04-25,3141,Harold & Kumar Escape from Guantanamo Bay,12000000,43353117,38108728,31353117,2000
2008-04-25,4060,Standard Operating Procedure,5000000,332120,228830,-4667880,2000
2008-05-09,1218,Bangkok Dangerous,45000000,46598133,15298133,1598133,2000
2008-05-09,3894,"Surfer, Dude",6000000,36497,36497,-5963503,2000
2008-05-12,1612,Punisher: War Zone,35000000,10157534,8050977,-24842466,2000
2008-05-12,1872,Frost/Nixon,29000000,28452945,18622031,-547055,2000
2008-05-12,3183,Cadillac Records,12000000,8942516,8195551,-3057484,2000
2008-05-16,25,The Chronicles of Narnia: Prince Caspian,225000000,417341288,141621490,192341288,2000
2008-05-22,68,Indiana Jones and the Kingdom of the Crystal Skull,185000000,786558145,317023851,601558145,2000
2008-05-23,2496,The Children of Huang Shi,20000000,8221700,1031872,-11778300,2000
2008-05-23,3446,"War, Inc.",10000000,1299855,580862,-8700145,2000
2008-05-28,4111,Savage Grace,4600000,968805,434417,-3631195,2000
2008-05-30,894,Sex and the City,57500000,415247258,152647258,357747258,2000
2008-05-30,3515,The Strangers,9000000,83051676,52597610,74051676,2000
2008-05-30,4067,Stuck,5000000,67505,67505,-4932495,2000
2008-06-06,214,Kung Fu Panda,130000000,631910531,215434591,501910531,2000
2008-06-06,408,You Don't Mess With the Zohan,90000000,202910991,100018837,112910991,2000
2008-06-06,2627,Mongol,18000000,27147349,5705761,9147349,2000
2008-06-06,3645,And When Did You Last See Your Father?,8000000,2476491,1071240,-5523509,2000
2008-06-08,1943,The Sisterhood of the Traveling Pants 2,27000000,44270131,44089964,17270131,2000
2008-06-08,1971,The Pineapple Express,26000000,102404019,87341380,76404019,2000
2008-06-08,4039,Bottle Shock,5000000,4815890,4078607,-184110,2000
2008-06-13,196,The Incredible Hulk,137500000,263417913,134806913,125917913,2000
2008-06-13,810,The Happening,60000000,162778384,64506874,102778384,2000
2008-06-13,5242,Baghead,200000,140016,140016,-59984,2000
2008-06-20,498,Get Smart,80000000,226739416,130319208,146739416,2000
2008-06-20,766,The Love Guru,62000000,40123346,32200122,-21876654,2000
2008-06-20,3364,Kit Kittredge: An American Girl,10000000,17657973,17657973,7657973,2000
2008-06-20,4487,Brick Lane,2500000,3838486,1094998,1338486,2000
2008-06-27,75,WALL-E,180000000,532590994,223808164,352590994,2000
2008-06-27,582,Wanted,75000000,342416460,134508551,267416460,2000
2008-07-03,315,"10,000 B.C.",105000000,269065678,94784201,164065678,2000
2008-07-03,2379,The Bank Job,20000000,66143005,30060660,46143005,2000
2008-07-03,2505,長江七號 (CJ7),20000000,47300771,206678,27300771,2000
2008-07-03,3205,Married Life,12000000,2975188,1506998,-9024812,2000
2008-07-03,4731,Snow Angels,1500000,414404,402858,-1085596,2000
2008-07-10,4532,Jack Brooks: Monster Slayer,2150000,0,0,-2150000,2000
2008-07-11,149,Madagascar: Escape 2 Africa,150000000,599516844,180010950,449516844,2000
2008-07-11,1408,Soul Men,40000000,12345883,12082391,-27654117,2000
2008-07-11,1889,Role Models,28000000,94500826,67300955,66500826,2000
2008-07-11,3104,The Boy in the Striped Pajamas,12500000,44083403,9046156,31583403,2000
2008-07-11,3585,Repo! The Genetic Opera,8500000,198883,140244,-8301117,2000
2008-07-18,67,The Dark Knight,185000000,1002572859,533345358,817572859,2000
2008-07-18,988,Mamma Mia!,52000000,615748877,144130063,563748877,2000
2008-07-18,1486,Space Chimps,37000000,67029956,30105968,30029956,2000
2008-07-18,2919,Transsiberian,15000000,6379575,2203641,-8620425,2000
2008-07-18,5348,The Legend of God's Gun,30000,243768,243768,213768,2000
2008-07-25,719,Step Brothers,65000000,128468793,100468793,63468793,2000
2008-07-25,1585,The X-Files: I Want to Believe,35000000,68170792,20982478,33170792,2000
2008-07-25,2771,Bienvenue chez les Ch'tis,16000000,247474497,1477650,231474497,2000
2008-07-25,4650,Man on Wire,1900000,5617067,2962242,3717067,2000
2008-08-01,3477,White Noise 2: The Light,10000000,8243567,0,-1756433,2000
2008-08-02,623,Fool's Gold,72500000,109362966,70231041,36862966,2000
2008-08-02,1931,Welcome Home Roscoe Jenkins,27500000,43607627,42436517,16107627,2000
2008-08-02,2902,In Bruges,15000000,34533783,7800825,19533783,2000
2008-08-04,2650,Day of the Dead,18000000,0,0,-18000000,2000
2008-08-10,2628,RocknRolla,18000000,27794339,5700626,9794339,2000
2008-08-13,405,Tropic Thunder,90000000,191091250,110461307,101091250,2000
2008-08-14,5380,The Rise and Fall of Miss Thang,10000,401,401,-9599,2000
2008-08-15,1567,Mirrors,35000000,77220596,30691439,42220596,2000
2008-08-15,2109,Fly Me To the Moon,25000000,43530281,14543943,18530281,2000
2008-08-15,2744,Vicky Cristina Barcelona,16000000,104504817,23216709,88504817,2000
2008-08-15,3569,Star Wars: The Clone Wars,8500000,68695443,35161554,60195443,2000
2008-08-20,2905,The Rocker,15000000,8767338,6409528,-6232662,2000
2008-08-22,741,Death Race,65000000,72516819,36316032,7516819,2000
2008-08-22,2043,The House Bunny,25000000,71390601,48237389,46390601,2000
2008-08-22,2217,The Longshots,23000000,11778396,11511323,-11221604,2000
2008-08-22,3536,Hamlet 2,9000000,4934104,4886216,-4065896,2000
2008-08-26,1472,Virgin Territory,38000000,5473041,0,-32526959,2000
2008-08-26,4241,Purple Violets,4000000,0,0,-4000000,2000
2008-08-27,2251,Traitor,22000000,27882226,23530831,5882226,2000
2008-08-29,1208,Babylon A.D.,45000000,70216497,22532572,25216497,2000
2008-08-29,2430,Disaster Movie,20000000,36720752,14190901,16720752,2000
2008-08-29,3866,College,6000000,6176114,4694491,176114,2000
2008-08-29,4092,Obsluhoval jsem anglického krále,4900000,7174984,617228,2274984,2000
2008-09-05,268,Speed Racer,120000000,93394462,43945766,-26605538,2000
2008-09-05,1523,What Happens in Vegas...,35000000,218535708,80277646,183535708,2000
2008-09-05,5116,Poultrygeist: Night of the Chicken Dead,450000,22623,13804,-427377,2000
2008-09-19,1952,The Duchess,27000000,45160110,13848978,18160110,2000
2008-09-19,2256,Igor,22000000,31013349,19528602,9013349,2000
2008-09-19,2352,Lakeview Terrace,20000000,44821299,39263506,24821299,2000
2008-09-19,2403,Appaloosa,20000000,27911453,20211394,7911453,2000
2008-09-19,2407,My Best Friend's Girl,20000000,34787111,19219250,14787111,2000
2008-09-19,2438,Ghost Town,20000000,29843245,13252641,9843245,2000
2008-09-19,3799,Tropa de Elite,6537890,14319195,8744,7781305,2000
2008-09-26,508,Eagle Eye,80000000,178066569,101440743,98066569,2000
2008-09-26,1224,Miracle at St. Anna,45000000,9676497,7916887,-35323503,2000
2008-09-26,3012,The Lucky Ones,14000000,266967,266967,-13733033,2000
2008-09-26,4306,Choke,3400000,4124277,2926565,724277,2000
2008-09-26,5048,Fireproof,500000,33473297,33456317,32973297,2000
2008-10-10,699,Body of Lies,67500000,118556530,39394666,51056530,2000
2008-10-10,1469,City of Ember,38000000,17830244,7871693,-20169756,2000
2008-10-10,1475,The Express,37500000,9813309,9793406,-27686691,2000
2008-10-10,3146,Quarantine,12000000,41924774,31691811,29924774,2000
2008-10-10,5239,Call+Response,200000,212989,212989,12989,2000
2008-10-10,5245,Good Dick,200000,52443,28835,-147557,2000
2008-10-12,1659,The Reader,32500000,112964875,34194407,80464875,2000
2008-10-12,5161,Wendy and Lucy,300000,1416046,865695,1116046,2000
2008-10-14,4628,No Man's Land: The Rise of Reeker,2000000,0,0,-2000000,2000
2008-10-17,1549,Max Payne,35000000,85761789,40687294,50761789,2000
2008-10-17,1962,What Just Happened,27000000,2412123,1090947,-24587877,2000
2008-10-17,2005,W.,25100000,28575778,25534493,3475778,2000
2008-10-17,2548,Sex Drive,19000000,10412485,8402485,-8587515,2000
2008-10-17,3254,The Secret Life of Bees,11000000,39984023,37770162,28984023,2000
2008-10-21,5207,Sunday School Musical,250000,0,0,-250000,2000
2008-10-24,947,Changeling,55000000,113805580,35739802,58805580,2000
2008-10-24,1823,Pride and Glory,30000000,43440721,15740721,13440721,2000
2008-10-24,2481,Passchendaele,20000000,4453327,4452423,-15546673,2000
2008-10-24,2486,"Synecdoche, New York",20000000,4383538,3083538,-15616462,2000
2008-10-24,3243,High School Musical 3: Senior Year,11000000,274392880,90559416,263392880,2000
2008-10-24,3286,Saw V,10800000,118209778,56746769,107409778,2000
2008-10-24,4123,Låt den rätte komma in,4500000,12247682,2122085,7747682,2000
2008-10-24,4604,Roadside Romeo,2000000,2046090,55202,46090,2000
2008-10-24,5128,Heroes,400000,655538,655538,255538,2000
2008-10-31,2178,Zack and Miri Make a Porno,24000000,36856306,31457946,12856306,2000
2008-10-31,4007,The Haunting of Molly Hartley,5000000,15318257,13442412,10318257,2000
2008-10-31,4494,The Other End of the Line,2500000,507446,115504,-1992554,2000
2008-10-31,4615,Eden Lake,2000000,4294373,7321,2294373,2000
2008-10-31,4737,My Name is Bruce,1500000,173066,173066,-1326934,2000
2008-10-31,5223,Little Big Top,240000,7484,7484,-232516,2000
2008-11-01,876,In the Name of the King: A Dungeon Siege Tale,60000000,13233220,4775656,-46766780,2000
2008-11-01,2877,The Pirates Who Don't Do Anything: A VeggieTales Movie,15000000,13248444,12981269,-1751556,2000
2008-11-03,3786,Stargate - The Ark of Truth,7000000,0,0,-7000000,2000
2008-11-04,2386,Street Kings,20000000,65454793,26415649,45454793,2000
2008-11-04,2582,Prom Night,18000000,57193655,43869350,39193655,2000
2008-11-04,4187,The Visitor,4000000,19174817,9427026,15174817,2000
2008-11-07,481,Hellboy II: The Golden Army,82500000,160388063,75986503,77888063,2000
2008-11-07,872,Meet Dave,60000000,50648806,11803254,-9351194,2000
2008-11-07,1165,Journey to the Center of the Earth,45000000,243180937,101704370,198180937,2000
2008-11-07,4308,August,3400000,12636,12636,-3387364,2000
2008-11-14,21,Quantum of Solace,230000000,591692078,169368427,361692078,2000
2008-11-14,4492,Fuel,2500000,174255,174255,-2325745,2000
2008-11-21,161,Bolt,150000000,328015209,114053759,178015209,2000
2008-11-21,1476,Twilight,37000000,402280159,192769854,365280159,2000
2008-11-21,4917,Special,1000000,26822,7202,-973178,2000
2008-11-26,225,Australia,130000000,215080810,49554002,85080810,2000
2008-11-26,502,Four Christmases,80000000,168311558,120146040,88311558,2000
2008-11-26,2374,Milk,20000000,57293371,31841299,37293371,2000
2008-12-09,841,Righteous Kill,60000000,78481410,40081410,18481410,2000
2008-12-09,1481,Burn After Reading,37000000,168167798,60355347,131167798,2000
2008-12-09,2742,The Women,16000000,50103808,26902075,34103808,2000
2008-12-11,2960,Slumdog Millionaire,14000000,384519665,141319928,370519665,2000
2008-12-12,519,The Day the Earth Stood Still,80000000,233066978,79366978,153066978,2000
2008-12-12,893,"Che, El Ar the Argentine",58000000,30118557,293708,-27881443,2000
2008-12-12,1425,Delgo,40000000,915840,915840,-39084160,2000
2008-12-12,2011,Gran Torino,25000000,274543085,148095302,249543085,2000
2008-12-12,2369,Doubt,20000000,53191101,33446470,33191101,2000
2008-12-12,3785,The Kings of Appletown,7000000,0,0,-7000000,2000
2008-12-12,4463,Los Cronocrímenes,2600000,564474,39127,-2035526,2000
2008-12-17,3838,The Wrestler,6000000,46634275,26238243,40634275,2000
2008-12-19,824,The Tale of Despereaux,60000000,90482317,50877145,30482317,2000
2008-12-19,972,Seven Pounds,54000000,166617328,69951824,112617328,2000
2008-12-19,1018,Yes Man,50000000,225990976,97690976,175990976,2000
2008-12-25,122,The Curious Case of Benjamin Button,160000000,329809326,127509326,169809326,2000
2008-12-25,413,Valkyrie,90000000,203902107,83077762,113902107,2000
2008-12-25,504,Bedtime Stories,80000000,221468935,110101975,141468935,2000
2008-12-25,777,Marley & Me,60000000,247812011,143153751,187812011,2000
2008-12-25,865,The Spirit,60000000,39006188,19806188,-20993812,2000
2008-12-25,4577,Waltz with Bashir,2000000,13912289,2283849,11912289,2000
2008-12-26,1207,Revolutionary Road,45000000,79564960,22911480,34564960,2000
2008-12-31,1631,Black Water Transit,35000000,0,0,-35000000,2000
2008-12-31,2510,Koltchak,20000000,38585047,0,18585047,2000
2008-12-31,2648,I Come with the Rain,18000000,627422,0,-17372578,2000
2008-12-31,2774,Good,16000000,31631,31631,-15968369,2000
2008-12-31,2943,Bathory,15000000,3436763,0,-11563237,2000
2008-12-31,3018,Ca$h,13700000,11738256,0,-1961744,2000
2008-12-31,3940,Animals,5500000,0,0,-5500000,2000
2008-12-31,4075,The Cottage,5000000,1504960,0,-3495040,2000
2008-12-31,4453,Rejsen til Saturn,2700000,5377665,0,2677665,2000
2008-12-31,4466,Silver Medalist,2600000,0,0,-2600000,2000
2008-12-31,4529,Impact Point,2200000,0,0,-2200000,2000
2008-12-31,4813,Extreme Movie,1200000,81338,0,-1118662,2000
2008-12-31,4933,Steppin: The Movie,1000000,0,0,-1000000,2000
2008-12-31,4975,Harrison Montgomery,850000,0,0,-850000,2000
2009-01-05,150,X-Men Origins: Wolverine,150000000,374825760,179883157,224825760,2000
2009-01-07,322,Public Enemies,102500000,212282709,97104620,109782709,2000
2009-01-07,399,Ice Age: Dawn of the Dinosaurs,90000000,859701857,196573705,769701857,2000
2009-01-12,4928,Frat Party,1000000,0,0,-1000000,2000
2009-01-16,1079,Defiance,50000000,52987754,28644813,2987754,2000
2009-01-16,1526,Hotel for Dogs,35000000,122213085,73034460,87213085,2000
2009-01-16,1966,Paul Blart: Mall Cop,26000000,185904750,146336178,159904750,2000
2009-01-16,2540,Notorious,19000000,45005151,36843682,26005151,2000
2009-01-16,2966,My Bloody Valentine,14000000,102836002,51545952,88836002,2000
2009-01-23,867,Inkheart,60000000,66655938,17303424,6655938,2000
2009-01-23,1116,Outlander,50000000,1250617,166003,-48749383,2000
2009-01-23,1545,Underworld 3: Rise of the Lycans,35000000,89102315,45802315,54102315,2000
2009-01-23,5003,Donkey Punch,750000,814801,19367,64801,2000
2009-01-30,2012,Taken,25000000,226941585,145000989,201941585,2000
2009-01-30,3622,New in Town,8000000,29937909,16734283,21937909,2000
2009-01-30,4319,Entre les murs,3250000,34114067,3766810,30864067,2000
2009-02-10,2195,Zombieland,23600000,102236596,75590286,78636596,2000
2009-02-10,2560,The Invention of Lying,18500000,32679264,18451251,14179264,2000
2009-02-10,2876,Whip It,15000000,18856151,13043363,3856151,2000
2009-02-10,3739,A Serious Man,7000000,30360570,9228788,23360570,2000
2009-02-13,1087,The International,50000000,53850527,25450527,3850527,2000
2009-02-13,2673,Friday the 13th,17000000,92670237,65002019,75670237,2000
2009-02-13,3197,Two Lovers,12000000,16349034,3149034,4349034,2000
2009-02-13,3826,Gomorra,6200000,37339594,1579146,31139594,2000
2009-02-17,4077,Dead Like Me: Life After Death,5000000,0,0,-5000000,2000
2009-02-20,2417,Fired Up,20000000,18608570,17231291,-1391430,2000
2009-02-20,2657,Madea Goes To Jail,17500000,90508336,90508336,73008336,2000
2009-02-27,1110,Street Fighter: The Legend of Chun-Li,50000000,12335036,9135036,-37664964,2000
2009-02-27,5081,Scott Walker: 30 Century Man,500000,77121,6840,-422879,2000
2009-03-04,444,Fast & Furious,85000000,363064265,155064265,278064265,2000
2009-03-04,3492,Adventureland,9800000,17553055,16044025,7753055,2000
2009-03-13,1035,Race to Witch Mountain,50000000,105103783,67172594,55103783,2000
2009-03-13,2836,The Last House on the Left,15000000,46526243,32752215,31526243,2000
2009-03-13,3869,Miss March,6000000,4713059,4543320,-1286941,2000
2009-03-13,4013,Sunshine Cleaning,5000000,17329337,12062558,12329337,2000
2009-03-20,840,Duplicity,60000000,81079566,40572825,21079566,2000
2009-03-20,1027,Knowing,50000000,186450317,79957634,136450317,2000
2009-03-20,1313,"I Love You, Man",40000000,91729503,71440011,51729503,2000
2009-03-20,4609,Super Capers,2000000,30955,30955,-1969045,2000
2009-03-27,88,Monsters vs. Aliens,175000000,381687380,198351526,206687380,2000
2009-03-27,2444,12 Rounds,20000000,17306648,12234694,-2693352,2000
2009-04-09,1096,Gamer,50000000,42002029,20534907,-7997971,2000
2009-04-09,2833,All About Steve,15000000,40127259,33862903,25127259,2000
2009-04-09,3683,Extract,7500000,10849158,10823158,3349158,2000
2009-04-12,1727,Up in the Air,30000000,166842739,83823381,136842739,2000
2009-04-12,1987,Brothers,26000000,45043870,28544157,19043870,2000
2009-04-12,2421,Armored,20000000,23661038,15988876,3661038,2000
2009-04-12,2455,Everybody's Fine,20000000,9208876,9208876,-10791124,2000
2009-04-12,4152,Paa,4300000,9791282,199228,5491282,2000
2009-04-17,843,State of Play,60000000,88832210,37017955,28832210,2000
2009-04-17,1320,17 Again,40000000,139474906,64167069,99474906,2000
2009-04-17,2433,Crank 2: High Voltage,20000000,35472739,13684249,15472739,2000
2009-04-17,4496,Sleep Dealer,2500000,108907,80136,-2391093,2000
2009-04-22,1145,Earth,47000000,116773317,32011576,69773317,2000
2009-04-23,5078,Home,500000,44793168,15433,44293168,2000
2009-04-24,852,The Soloist,60000000,38389024,31720158,-21610976,2000
2009-04-24,2329,Obsessed,20000000,73964713,68261644,53964713,2000
2009-04-24,2644,The Informers,18000000,315000,315000,-17685000,2000
2009-05-06,354,Land of the Lost,100000000,69548641,49438370,-30451359,2000
2009-05-06,1508,The Hangover,35000000,465764086,277322503,430764086,2000
2009-05-06,2298,Away We Go,21000000,10108016,9451946,-10891984,2000
2009-05-06,2699,My Life in Ruins,17000000,20465206,8665206,3465206,2000
2009-05-06,3226,Home,12000000,1620056,0,-10379944,2000
2009-05-15,156,Angels & Demons,150000000,490875846,133375846,340875846,2000
2009-05-15,2485,The Brothers Bloom,20000000,5531756,3531756,-14468244,2000
2009-05-21,53,Terminator Salvation,200000000,365491792,125322469,165491792,2000
2009-05-22,151,Night at the Museum: Battle of the Smithsonian,150000000,402231063,177243721,252231063,2000
2009-05-22,2081,Dance Flick,25000000,32092761,25662155,7092761,2000
2009-05-22,3006,Easy Virtue,14000000,20537741,2656784,6537741,2000
2009-05-22,4771,The Girlfriend Experience,1300000,1005840,695840,-294160,2000
2009-05-26,3484,The Devil's Tomb,10000000,0,0,-10000000,2000
2009-05-29,86,Up,175000000,731542621,293004164,556542621,2000
2009-05-29,1772,Drag Me To Hell,30000000,91388487,42100625,61388487,2000
2009-05-29,3067,Män som hatar kvinnor,13000000,109421911,12749992,96421911,2000
2009-05-29,4744,Pontypool,1500000,31916,3865,-1468084,2000
2009-06-02,805,Coraline,60000000,126037057,75286229,66037057,2000
2009-06-02,1294,He's Just Not That Into You,40000000,181053657,93953653,141053657,2000
2009-06-02,1460,Push,38000000,44411527,31811527,6411527,2000
2009-06-02,3879,Polytechnique,6000000,1418304,1418304,-4581696,2000
2009-06-03,194,Watchmen,138000000,184068357,107509799,46068357,2000
2009-06-10,5277,A Charlie Brown Christmas,150000,0,0,-150000,2000
2009-06-11,63,Disney's A Christmas Carol,190000000,315709697,137855863,125709697,2000
2009-06-11,2105,The Box,25000000,26341896,15051977,1341896,2000
2009-06-11,2177,The Men Who Stare at Goats,24000000,67348218,32428195,43348218,2000
2009-06-11,3317,Precious (Based on the Novel Push by Sapphire),10000000,68722848,47566524,58722848,2000
2009-06-11,3349,The Fourth Kind,10000000,49486874,26218170,39486874,2000
2009-06-19,835,Year One,60000000,57604723,43337279,-2395277,2000
2009-06-19,1280,The Proposal,40000000,314709717,163958031,274709717,2000
2009-06-19,2907,Whatever Works,15000000,35106706,5306706,20106706,2000
2009-06-19,4989,Dod sno,800000,2194020,46742,1394020,2000
2009-06-23,2712,Chasseurs de dragons,17000000,13446115,0,-3553885,2000
2009-06-24,30,Transformers: Revenge of the Fallen,210000000,836519699,402111870,626519699,2000
2009-06-26,1930,My Sister's Keeper,27500000,96673002,49200230,69173002,2000
2009-06-26,2222,Chéri,23000000,2715657,2715657,-20284343,2000
2009-06-26,2868,The Hurt Locker,15000000,49894223,17017811,34894223,2000
2009-06-26,4292,Surveillance,3500000,1396395,27349,-2103605,2000
2009-06-30,4294,The Betrayed,3500000,0,0,-3500000,2000
2009-07-04,3224,1612,12000000,5400624,0,-6599376,2000
2009-07-04,4833,Faith Like Potatoes,1100000,0,0,-1100000,2000
2009-07-04,5006,Bled,750000,0,0,-750000,2000
2009-07-07,4074,Flying By,5000000,4568257,0,-431743,2000
2009-07-08,89,G.I. Joe: The Rise of Cobra,175000000,302469017,150201498,127469017,2000
2009-07-08,1293,Julie & Julia,40000000,126646119,94125426,86646119,2000
2009-07-08,2985,A Perfect Getaway,14000000,22815460,15515460,8815460,2000
2009-07-11,3220,Nanjing! Nanjing!,12000000,20122558,122558,8122558,2000
2009-07-14,4537,[Rec],2100000,23266821,0,21166821,2000
2009-07-15,14,Harry Potter and the Half-Blood Prince,250000000,935083686,301959197,685083686,2000
2009-07-17,4931,The Poker House,1000000,0,0,-1000000,2000
2009-07-24,160,G-Force,150000000,292817841,119436770,142817841,2000
2009-07-24,1446,The Ugly Truth,38000000,205298907,88915214,167298907,2000
2009-07-24,2350,Orphan,20000000,78769428,41596251,58769428,2000
2009-07-29,4325,Adam,3200000,2828590,2277396,-371410,2000
2009-07-31,624,Funny People,72500000,71880305,51855045,-619695,2000
2009-07-31,1205,Aliens in the Attic,45000000,59551283,25200412,14551283,2000
2009-07-31,3553,Flammen og Citronen,9000000,1635241,148089,-7364759,2000
2009-07-31,4365,The Collector,3000000,10473836,7712114,7473836,2000
2009-08-05,181,Star Trek,140000000,385680446,257730019,245680446,2000
2009-08-05,3892,Julia,6000000,1365108,65108,-4634892,2000
2009-08-05,4217,Adoration,4000000,384244,294244,-3615756,2000
2009-08-05,4358,Next Day Air,3000000,10172519,10027047,7172519,2000
2009-08-14,1436,The Time Traveler's Wife,39000000,102332135,63414846,63332135,2000
2009-08-14,1637,Gake no ue no Ponyo,34000000,205312666,15090399,171312666,2000
2009-08-14,1714,District 9,30000000,212453431,115646235,182453431,2000
2009-08-14,2477,Bandslam,20000000,12967829,5210988,-7032171,2000
2009-08-14,3376,"The Goods: Live Hard, Sell Hard",10000000,15297318,15122676,5297318,2000
2009-08-14,4071,Grace,5000000,8297,8297,-4991703,2000
2009-08-21,642,Inglourious Basterds,70000000,316915264,120774594,246915264,2000
2009-08-21,2401,Shorts,20000000,29870801,20919166,9870801,2000
2009-08-21,2522,Der Baader Meinhof Komplex,19700000,16498827,476270,-3201173,2000
2009-08-21,2906,Post Grad,15000000,6561243,6380019,-8438757,2000
2009-08-21,3454,World's Greatest Dad,10000000,295750,221805,-9704250,2000
2009-08-21,3480,Fifty Dead Men Walking,10000000,997921,0,-9002079,2000
2009-08-26,1876,Taking Woodstock,29000000,10066366,7460204,-18933634,2000
2009-08-28,1319,The Final Destination,40000000,187384627,66477700,147384627,2000
2009-08-28,2835,Halloween 2,15000000,38512850,33392973,23512850,2000
2009-08-28,3469,The Open Road,10000000,19716,19716,-9980284,2000
2009-09-01,1747,Bride Wars,30000000,115150424,58715510,85150424,2000
2009-09-01,1878,"Che, Part 1: The Argentine",29000000,1733532,1733532,-27266468,2000
2009-09-01,2732,The Unborn,16000000,78208812,42670410,62208812,2000
2009-09-01,4018,Not Easily Broken,5000000,10732909,10572742,5732909,2000
2009-09-09,1793,9,30000000,48559999,31749894,18559999,2000
2009-09-10,783,Couples Retreat,60000000,172450423,109205660,112450423,2000
2009-09-10,3238,St. Trinian’s,11400000,29830239,15000,18430239,2000
2009-09-10,3458,Free Style,10000000,721108,141108,-9278892,2000
2009-09-10,3682,An Education,7500000,29652736,12574914,22152736,2000
2009-09-10,3823,The Damned United,6400000,4199874,449865,-2200126,2000
2009-09-10,4743,Trucker,1500000,52429,52429,-1447571,2000
2009-09-10,5224,Bronson,230000,2703762,104979,2473762,2000
2009-09-17,3581,Bright Star,8500000,17220091,4444637,8720091,2000
2009-09-18,335,Cloudy with a Chance of Meatballs,100000000,236827677,124870275,136827677,2000
2009-09-18,2246,The Informant!,22000000,41771168,33316821,19771168,2000
2009-09-18,2506,The Burning Plain,20000000,1167092,200730,-18832908,2000
2009-09-18,2601,Love Happens,18000000,36133014,22965110,18133014,2000
2009-09-18,2749,Jennifer's Body,16000000,31943401,16204793,15943401,2000
2009-09-18,4874,The Secrets of Jonathan Sperry,1000000,1355079,1355079,355079,2000
2009-09-22,3483,Adam Resurrected,10000000,90909,0,-9909091,2000
2009-09-23,2428,Capitalism: A Love Story,20000000,19121531,14363397,-878469,2000
2009-09-25,534,Surrogates,80000000,119668350,38577772,39668350,2000
2009-09-25,1411,Pandorum,40000000,17033431,10330853,-22966569,2000
2009-09-25,2221,Coco avant Chanel,23000000,50813834,6113834,27813834,2000
2009-09-25,2602,Fame,18000000,80227619,22455510,62227619,2000
2009-09-25,3762,I Hope They Serve Beer in Hell,7000000,1429453,1429299,-5570547,2000
2009-09-25,5110,Paranormal Activity,450000,194183034,107918810,193733034,2000
2009-10-04,1729,Hannah Montana the Movie,30000000,169173206,79576189,139173206,2000
2009-10-04,1835,Dragonball Evolution,30000000,58228460,9362785,28228460,2000
2009-10-04,2599,Observe and Report,18000000,27148898,24007324,9148898,2000
2009-10-04,5150,Royal Kill,350000,0,0,-350000,2000
2009-10-07,1252,Brüno,42000000,130788243,60054530,88788243,2000
2009-10-07,2614,"I Love You, Beth Cooper",18000000,16382538,14800725,-1617462,2000
2009-10-11,5210,Ink,250000,0,0,-250000,2000
2009-10-16,344,Where the Wild Things Are,100000000,99123656,77233467,-876344,2000
2009-10-16,978,Law Abiding Citizen,53000000,131159781,73357727,78159781,2000
2009-10-16,2381,The Stepfather,20000000,29227561,29062561,9227561,2000
2009-10-16,3472,Janky Promoters,10000000,9069,9069,-9990931,2000
2009-10-23,747,Astro Boy,65000000,41636243,19551067,-23363757,2000
2009-10-23,1402,Amelia,40000000,19756077,14279575,-20243923,2000
2009-10-23,1403,Cirque du Freak: The Vampire's Assistant,40000000,39753957,14046595,-246043,2000
2009-10-23,2933,Ong-Bak 2,15000000,7583050,102458,-7416950,2000
2009-10-23,3257,Saw VI,11000000,69752402,27693292,58752402,2000
2009-10-23,3465,Motherhood,10000000,723388,93388,-9276612,2000
2009-10-27,3015,Stan Helsing: A Parody,14000000,1553556,0,-12446444,2000
2009-10-28,808,Michael Jackson's This Is It,60000000,252091016,72091016,192091016,2000
2009-10-30,3499,Gentlemen Broncos,9500000,118482,113682,-9381518,2000
2009-10-30,3628,The Boondock Saints 2: All Saints Day,8000000,10629320,10273187,2629320,2000
2009-10-30,4904,The House of the Devil,1000000,102812,101215,-897188,2000
2009-11-08,4978,London to Brighton,825000,610776,0,-214224,2000
2009-11-09,1607,Whiteout,35000000,12254746,10275638,-22745254,2000
2009-11-09,2534,I Can Do Bad All By Myself,19000000,51733921,51733921,32733921,2000
2009-11-09,3102,Sorority Row,12500000,26735797,11965282,14235797,2000
2009-11-09,5268,The Horse Boy,160000,156612,156612,-3388,2000
2009-11-12,379,The Lovely Bones,95000000,94894448,44114232,-105552,2000
2009-11-12,842,Invictus,60000000,124514011,37491364,64514011,2000
2009-11-12,3741,A Single Man,7000000,28142379,9176000,21142379,2000
2009-11-12,4838,Rocket Singh: Salesman of the Year,1070000,5348767,164649,4278767,2000
2009-11-13,52,2012,200000000,788408539,166112167,588408539,2000
2009-11-13,1112,The Boat That Rocked,50000000,37472651,8017467,-12527349,2000
2009-11-13,1390,The Fantastic Mr. Fox,40000000,47085064,21002919,7085064,2000
2009-11-13,3816,The Messenger,6500000,1744952,1109660,-4755048,2000
2009-11-20,839,Planet 51,60000000,108996113,42194060,48996113,2000
2009-11-20,1001,The Twilight Saga: New Moon,50000000,687557727,296623634,637557727,2000
2009-11-20,1428,Red Cliff,40000000,119627047,627047,79627047,2000
2009-11-20,1509,The Blind Side,35000000,305705794,255959475,270705794,2000
2009-11-20,2144,Bad Lieutenant: Port of Call New Orleans,25000000,12413949,1702112,-12586051,2000
2009-11-20,4611,The Missing Person,2000000,17896,17896,-1982104,2000
2009-11-25,314,The Princess and the Frog,105000000,270997378,104400899,165997378,2000
2009-11-25,1068,Ninja Assassin,50000000,62209892,38122883,12209892,2000
2009-11-25,1542,Old Dogs,35000000,95104304,49492060,60104304,2000
2009-11-25,2131,The Road,25000000,29206732,8114270,4206732,2000
2009-11-25,2146,Me and Orson Welles,25000000,1190003,1190003,-23809997,2000
2009-11-27,3237,The Cry of the Owl,11500000,0,0,-11500000,2000
2009-12-06,301,The Taking of Pelham 123,110000000,152364370,65452312,42364370,2000
2009-12-06,959,Imagine That,55000000,16123323,16123323,-38876677,2000
2009-12-06,4035,Moon,5000000,10676073,5010163,5676073,2000
2009-12-06,4864,"Food, Inc.",1000000,4731944,4417674,3731944,2000
2009-12-16,3568,Crazy Heart,8500000,47417251,39471742,38917251,2000
2009-12-18,1,Avatar,425000000,2783918982,760507625,2358918982,2000
2009-12-18,546,Nine,80000000,53508858,19676965,-26491142,2000
2009-12-18,892,Did You Hear About the Morgans?,58000000,80480566,29580087,22480566,2000
2009-12-18,1604,The Young Victoria,35000000,31878891,11001272,-3121109,2000
2009-12-23,637,Alvin and the Chipmunks: The Squeakquel,70000000,443483213,219614612,373483213,2000
2009-12-25,398,Sherlock Holmes,90000000,498438212,209028679,408438212,2000
2009-12-25,452,It’s Complicated,85000000,224614744,112735375,139614744,2000
2009-12-25,1838,The Imaginarium of Doctor Parnassus,30000000,64352607,7689607,34352607,2000
2009-12-29,4620,Lesbian Vampire Killers,2000000,3620902,0,1620902,2000
2009-12-30,2640,Das Weisse Band: Eine deutsche Kindergeschichte,18000000,25727044,2222862,7727044,2000
2009-12-31,1489,Obitaemyy ostrov,36500000,15000000,0,-21500000,2000
2009-12-31,2226,Shi Yue Wei Cheng,23000000,44195779,0,21195779,2000
2009-12-31,3485,Good Intentions,10000000,0,0,-10000000,2000
2009-12-31,3670,Chirstmas in Beverly Hills,8000000,0,0,-8000000,2000
2009-12-31,4421,The Deported,3000000,0,0,-3000000,2000
2009-12-31,4422,Chicago Overcoat,3000000,0,0,-3000000,2000
2009-12-31,4430,Four Single Fathers,3000000,0,0,-3000000,2000
2009-12-31,4500,The Calling,2500000,0,0,-2500000,2000
2009-12-31,4512,Nikté,2400000,1333891,0,-1066109,2000
2009-12-31,4627,Nine Dead,2000000,0,0,-2000000,2000
2009-12-31,4674,Deadline,1800000,0,0,-1800000,2000
2009-12-31,4781,The 41 Year Old Virgin Who Knocked Up Sarah Marshall and Felt Superbad About It,1300000,0,0,-1300000,2000
2009-12-31,4979,Crying With Laughter,820000,16909,0,-803091,2000
2009-12-31,5023,Starsuckers,640000,14812,0,-625188,2000
2009-12-31,5334,Big Things,50000,0,0,-50000,2000
2010-01-04,243,Clash of the Titans,125000000,493214888,163214888,368214888,2010
2010-01-07,158,The Last Airbender,150000000,319713881,131772187,169713881,2010
2010-01-09,2362,The American,20000000,67950723,35606376,47950723,2010
2010-01-09,5147,My Dog Tulip,350000,310891,246574,-39109,2010
2010-01-10,1291,The Social Network,40000000,224922135,96962694,184922135,2010
2010-01-10,1953,Case 39,27000000,28773827,13261851,1773827,2010
2010-01-10,2445,Let Me In,20000000,28270399,12134935,8270399,2010
2010-01-10,4402,Chain Letter,3000000,1022453,205842,-1977547,2010
2010-01-10,4420,Barry Munday,3000000,0,0,-3000000,2010
2010-01-10,4438,Freakonomics,2900000,172867,101270,-2727133,2010
2010-01-15,512,The Book of Eli,80000000,158750817,94835059,78750817,2010
2010-01-15,1914,The Spy Next Door,28000000,46752858,24307106,18752858,2010
2010-01-15,2624,The Last Station,18000000,15696146,6617867,-2303854,2010
2010-01-15,4397,Fish Tank,3000000,5922292,374675,2922292,2010
2010-01-22,1132,The Tooth Fairy,48000000,112610386,60022256,64610386,2010
2010-01-22,1702,Extraordinary Measures,31000000,15826984,12482741,-15173016,2010
2010-01-22,1983,Legion,26000000,67647574,40168080,41647574,2010
2010-01-22,3550,La fille du RER,9000000,208163,208163,-8791837,2010
2010-01-22,5054,To Save a Life,500000,3824868,3777210,3324868,2010
2010-01-26,5015,B-Girl,700000,1160,0,-698840,2010
2010-01-29,836,Edge of Darkness,60000000,82812456,43313890,22812456,2010
2010-01-29,4601,Saint John of Las Vegas,2000000,102645,102645,-1897355,2010
2010-01-29,4934,Zombies of Mass Destruction,1000000,0,0,-1000000,2010
2010-02-04,1430,The Warlords,40000000,38899792,129078,-1100208,2010
2010-02-04,2333,Why Did I Get Married Too?,20000000,60831067,60095852,40831067,2010
2010-02-04,3554,Leaves of Grass,9000000,85527,70066,-8914473,2010
2010-02-04,3890,The Greatest,6000000,117796,115862,-5882204,2010
2010-02-04,3897,Don McKay,6000000,13722,13722,-5986278,2010
2010-02-04,5370,Breaking Upwards,15000,115592,115592,100592,2010
2010-02-19,500,Shutter Island,80000000,299461782,128012934,219461782,2010
2010-02-19,1216,The Ghost Writer,45000000,65532491,15541549,20532491,2010
2010-02-19,1851,Le Petit Nicolas,30000000,52339566,201857,22339566,2010
2010-02-19,3463,Blood Done Sign My Name,10000000,109383,109383,-9890617,2010
2010-02-19,3464,The Good Guy,10000000,106466,100688,-9893534,2010
2010-02-19,4258,Defendor,3750000,44462,44462,-3705538,2010
2010-02-26,1484,Cop Out,37000000,55909910,44875481,18909910,2010
2010-02-26,2539,The Crazies,19000000,56445534,39123589,37445534,2010
2010-02-26,2784,The Yellow Handkerchief,15500000,318623,318623,-15181377,2010
2010-02-26,3081,Un Prophète,13000000,19910624,2087720,6910624,2010
2010-03-02,4883,Ajami,1000000,2721096,621859,1721096,2010
2010-03-09,1682,Going the Distance,32000000,43603990,17804299,11603990,2010
2010-03-09,3097,Machete,12500000,46370970,26593646,33870970,2010
2010-03-09,3217,San qiang pai an jing qi,12000000,310946,190946,-11689054,2010
2010-03-09,4914,16 to Life,1000000,11574,11574,-988426,2010
2010-03-12,1267,The Warrior's Way,42000000,8514325,5666340,-33485675,2010
2010-03-12,2499,All Good Things,20000000,873617,582024,-19126383,2010
2010-03-12,3032,Black Swan,13000000,331266710,106954678,318266710,2010
2010-03-12,3082,"I Love You, Phillip Morris",13000000,23014027,2037459,10014027,2010
2010-03-19,1179,The Bounty Hunter,45000000,135808837,67061228,90808837,2010
2010-03-19,1684,Repo Men,32000000,18195238,13942007,-13804762,2010
2010-03-19,2807,Diary of a Wimpy Kid,15000000,76954311,64003625,61954311,2010
2010-03-19,3498,The Runaways,9500000,5278632,3573673,-4221368,2010
2010-03-19,3862,City Island,6000000,8173486,6671283,2173486,2010
2010-03-23,4834,Lake Mungo,1100000,0,0,-1100000,2010
2010-03-26,110,How to Train Your Dragon,165000000,494870991,217581231,329870991,2010
2010-03-26,1494,Hot Tub Time Machine,36000000,65967750,50269859,29967750,2010
2010-03-26,3078,Chloe,13000000,11831131,3075255,-1168869,2010
2010-03-26,3775,Ca$h,7000000,46488,46488,-6953512,2010
2010-03-26,4405,The Eclipse,3000000,133411,133411,-2866589,2010
2010-03-31,2332,The Last Song,20000000,92678948,62950384,72678948,2010
2010-04-06,598,Killers,75000000,95572749,47059963,20572749,2010
2010-04-06,1073,Marmaduke,50000000,89895930,33644788,39895930,2010
2010-04-06,1322,Get Him to the Greek,40000000,91455875,61153526,51455875,2010
2010-04-06,1819,Splice,30000000,26857459,17010170,-3142541,2010
2010-04-06,3210,Ondine,12000000,557545,550472,-11442455,2010
2010-04-13,2512,Three Kingdoms: Resurrection of the Dragon,20000000,22139590,0,2139590,2010
2010-04-16,1900,Kick-Ass,28000000,97531134,48071303,69531134,2010
2010-04-16,2287,Death at a Funeral,21000000,48977233,42739347,27977233,2010
2010-04-16,3115,The Perfect Game,12500000,3931367,1089445,-8568633,2010
2010-04-16,3434,The Joneses,10000000,3541565,1475746,-6458435,2010
2010-04-16,3591,The City of Your Final Destination,8300000,1353296,493296,-6946704,2010
2010-04-16,4281,El secreto de sus ojos,3500000,40527719,6391436,37027719,2010
2010-04-22,548,Oceans,80000000,86787530,19422319,6787530,2010
2010-04-23,1555,The Back-up Plan,35000000,75281179,37490007,40281179,2010
2010-04-23,2086,The Losers,25000000,29863840,23591432,4863840,2010
2010-04-23,3461,Joheunnom nabbeunnom isanghannom,10000000,42226657,128486,32226657,2010
2010-04-30,1532,A Nightmare on Elm Street,35000000,117729621,63075011,82729621,2010
2010-04-30,1593,Furry Vengeance,35000000,39340177,17630465,4340177,2010
2010-04-30,3301,Housefull,10100000,18726300,1183658,8626300,2010
2010-04-30,3491,Gunless,9900000,458054,458054,-9441946,2010
2010-04-30,3703,Harry Brown,7300000,12023606,1818681,4723606,2010
2010-04-30,4253,The Good Heart,3800000,340930,20930,-3459070,2010
2010-04-30,4378,Please Give,3000000,4570178,4033574,1570178,2010
2010-05-02,995,From Paris With Love,52000000,53139168,24077427,1139168,2010
2010-05-02,2023,Dear John,25000000,142033509,80014842,117033509,2010
2010-05-02,2949,Shinjuku Incident,15000000,0,0,-15000000,2010
2010-05-02,3552,The Red Riding Trilogy: 1974,9000000,148826,148826,-8851174,2010
2010-05-03,44,Alice in Wonderland,200000000,1025491110,334191110,825491110,2010
2010-05-03,2687,Brooklyn's Finest,17000000,39233233,27163593,22233233,2010
2010-05-03,3646,The Secret of Kells,8000000,3582797,690290,-4417203,2010
2010-05-10,5208,Rust,250000,0,0,-250000,2010
2010-05-11,218,Megamind,130000000,321887208,148415853,191887208,2010
2010-05-11,718,Due Date,65000000,211739043,100539043,146739043,2010
2010-05-11,2290,For Colored Girls,21000000,38017873,37729698,17017873,2010
2010-05-11,2605,127 Hours,18000000,60217171,18335230,42217171,2010
2010-05-11,4257,Four Lions,3750000,2436111,310007,-1313889,2010
2010-05-14,33,Robin Hood,210000000,322241588,105269730,112241588,2010
2010-05-14,1754,Letters to Juliet,30000000,82148538,53032453,52148538,2010
2010-05-14,3162,Just Wright,12000000,21867665,21540363,9867665,2010
2010-05-14,3546,Princess Kaiulani,9000000,883887,883887,-8116113,2010
2010-05-14,5080,The Living Wake,500000,12232,12232,-487768,2010
2010-05-21,107,Shrek Forever After,165000000,756244673,238736787,591244673,2010
2010-05-21,3109,Solitary Man,12500000,4360548,4360548,-8139452,2010
2010-05-21,3393,MacGruber,10000000,8629895,8525600,-1370105,2010
2010-05-21,3507,Kites,9200000,17155193,1685269,7955193,2010
2010-05-21,3798,Perrier’s Bounty,6600000,828,828,-6599172,2010
2010-05-27,373,Sex and the City 2,95000000,294680778,95347692,199680778,2010
2010-05-28,55,Prince of Persia: Sands of Time,200000000,314594597,90759676,114594597,2010
2010-05-28,686,Agora,70000000,38992292,619423,-31007708,2010
2010-05-28,1269,Micmacs,42000000,11756922,1259693,-30243078,2010
2010-05-28,4029,Sea Rex 3D: Journey to a Prehistoric World,5000000,16515203,6096582,11515203,2010
2010-05-28,4157,George A. Romero's Survival of the Dead,4200000,101740,101740,-4098260,2010
2010-06-08,336,The Other Guys,100000000,170936470,119219978,70936470,2010
2010-06-08,1771,Step Up 3D,30000000,165889117,42400223,135889117,2010
2010-06-08,3008,Flipped,14000000,4127619,1755212,-9872381,2010
2010-06-08,3474,The Oxford Murders,10000000,17704131,4803,7704131,2010
2010-06-18,40,Toy Story 3,200000000,1069818229,415004880,869818229,2010
2010-06-18,1149,Jonah Hex,47000000,11022696,10547117,-35977304,2010
2010-06-18,3091,The Killer Inside Me,13000000,3617277,217277,-9382723,2010
2010-06-18,3413,Io sono l’amore,10000000,15132211,5005465,5132211,2010
2010-06-18,3744,Cyrus,7000000,10062896,7468936,3062896,2010
2010-06-18,4495,8: The Mormon Proposition,2500000,100280,100280,-2399720,2010
2010-06-23,271,Knight and Day,117000000,258751370,76423035,141751370,2010
2010-06-25,579,Grown Ups,75000000,272223430,162001186,197223430,2010
2010-06-25,3010,Les herbes folles,14000000,1903952,403952,-12096048,2010
2010-06-25,5155,Dogtooth,323000,1373407,110248,1050407,2010
2010-06-30,689,The Twilight Saga: Eclipse,68000000,706102828,300531751,638102828,2010
2010-06-30,2152,Love Ranch,25000000,146149,137885,-24853851,2010
2010-07-05,98,Iron Man 2,170000000,623561331,312433331,453561331,2010
2010-07-05,3764,Mother and Child,7000000,6537179,1110509,-462821,2010
2010-07-14,123,The Sorcerer's Apprentice,160000000,217986320,63150991,57986320,2010
2010-07-16,117,Inception,160000000,832584416,292576195,672584416,2010
2010-07-16,3914,Valhalla Rising,5700000,731613,30638,-4968387,2010
2010-07-16,3918,Standing Ovation,5600000,531806,531806,-5068194,2010
2010-07-23,221,Salt,130000000,290650494,118311368,160650494,2010
2010-07-23,2851,Ramona and Beezus,15000000,27469621,26167002,12469621,2010
2010-07-23,4131,Life During Wartime,4500000,281447,281447,-4218553,2010
2010-07-23,4139,Spoken Word,4500000,32961,32961,-4467039,2010
2010-07-30,465,Cats & Dogs: The Revenge of Kitty Galore,85000000,114979922,45539292,29979922,2010
2010-07-30,688,Dinner for Schmucks,69000000,86796502,73026337,17796502,2010
2010-07-30,1235,Charlie St. Cloud,44000000,48478084,31206263,4478084,2010
2010-07-30,3740,Get Low,7000000,10828305,9176933,3828305,2010
2010-07-30,3769,The Extra Man,7000000,492108,453377,-6507892,2010
2010-08-01,2378,Daybreakers,20000000,51445503,30101577,31445503,2010
2010-08-01,2542,Leap Year,19000000,32618920,25918920,13618920,2010
2010-08-01,2612,Youth in Revolt,18000000,19685588,15285588,1685588,2010
2010-08-10,1454,Life as We Know It,38000000,105887837,53374681,67887837,2010
2010-08-10,1536,Secretariat,35000000,60376247,59699513,25376247,2010
2010-08-10,2107,My Soul to Take,25000000,16727470,14744435,-8272530,2010
2010-08-10,2274,Stone,22000000,4065020,1810078,-17934980,2010
2010-08-10,3478,It's a Wonderful Afterlife,10000000,1642939,0,-8357061,2010
2010-08-10,3633,It's Kind of a Funny Story,8000000,6632950,6363628,-1367050,2010
2010-08-10,4569,Inside Job,2000000,7799257,4311834,5799257,2010
2010-08-10,4651,Nowhere Boy,1900000,7785229,1445366,5885229,2010
2010-08-10,4682,I Spit on Your Grave,1750000,1278471,93051,-471529,2010
2010-08-13,472,Scott Pilgrim vs. The World,85000000,48056764,31611316,-36943236,2010
2010-08-13,483,The Expendables,82000000,268268174,103068524,186268174,2010
2010-08-13,798,Eat Pray Love,60000000,206598789,80574010,146598789,2010
2010-08-13,4156,Animal Kingdom,4200000,8078683,1044039,3878683,2010
2010-08-18,2360,Vampires Suck,20000000,81424988,36661504,61424988,2010
2010-08-20,1569,Nanny McPhee and the Big Bang,35000000,97799865,29197642,62799865,2010
2010-08-20,2182,Piranha 3D,24000000,83660160,25003155,59660160,2010
2010-08-20,2541,The Switch,19000000,49858465,27758465,30858465,2010
2010-08-20,2630,Mao's Last Dancer,18000000,25941437,4806750,7941437,2010
2010-08-20,2689,Lottery Ticket,17000000,24719879,24719879,7719879,2010
2010-08-20,4093,Soul Kitchen,4900000,23347469,276901,18447469,2010
2010-08-27,1668,Takers,32000000,70587268,57744720,38587268,2010
2010-08-27,2932,Centurion,15000000,7885048,123570,-7114952,2010
2010-08-27,4614,Circle,2000000,10024,10024,-1989976,2010
2010-08-27,4660,The Last Exorcism,1800000,70165900,41034350,68365900,2010
2010-09-03,2777,Hachiko: A Dog's Story,16000000,47707417,0,31707417,2010
2010-09-04,920,Date Night,55000000,152269033,98711404,97269033,2010
2010-09-04,4136,After.Life,4500000,2481925,108596,-2018075,2010
2010-09-04,4388,Letters to God,3000000,3237452,2848587,237452,2010
2010-09-04,4493,Valley of the Hearts Delight,2500000,118666,118666,-2381334,2010
2010-09-04,4655,The Square,1900000,740932,406216,-1159068,2010
2010-09-07,687,Despicable Me,69000000,543495033,251513985,474495033,2010
2010-09-07,1335,Predators,40000000,127234389,52000688,87234389,2010
2010-09-07,3920,[Rec] 2,5600000,18527766,27766,12927766,2010
2010-09-07,4172,The Kids Are All Right,4000000,36275469,20811365,32275469,2010
2010-09-15,2917,Never Let Me Go,15000000,11173718,2434652,-3826282,2010
2010-09-17,1479,The Town,37000000,152566881,92186262,115566881,2010
2010-09-17,2391,Alpha and Omega 3D,20000000,48958353,25107267,28958353,2010
2010-09-17,3330,Devil,10000000,63354114,33679655,53354114,2010
2010-09-17,3601,Easy A,8000000,76200721,58401464,68200721,2010
2010-09-17,3792,Incendies,6800000,16038343,6857096,9238343,2010
2010-09-22,2916,You Will Meet a Tall Dark Stranger,15000000,34247816,3247816,19247816,2010
2010-09-24,352,Legend of the Guardians: The Owls of Ga'Hoole,100000000,139716717,55675313,39716717,2010
2010-09-24,663,Wall Street 2: Money Never Sleeps,70000000,137431619,52474616,67431619,2010
2010-09-24,2389,You Again,20000000,32838945,25702053,12838945,2010
2010-09-24,2773,Enter the Void,16000000,1467278,337997,-14532722,2010
2010-09-24,4590,The Virginity Hit,2000000,636706,636706,-1363294,2010
2010-09-24,4647,Buried,1987650,21270290,1044143,19282640,2010
2010-10-02,3227,Triangle,12000000,1595168,0,-10404832,2010
2010-10-09,895,Resident Evil: Afterlife,57500000,295874190,60128566,238374190,2010
2010-10-09,3796,Bran Nue Dae,6750000,6812530,113568,62530,2010
2010-10-09,4063,"Lovely, Still",5000000,282687,127564,-4717313,2010
2010-10-11,1370,Morning Glory,40000000,59795070,31011732,19795070,2010
2010-10-12,128,The Chronicles of Narnia: The Voyage of the Dawn Treader,155000000,418186950,104386950,263186950,2010
2010-10-12,347,The Tourist,100000000,278731369,67631157,178731369,2010
2010-10-12,2504,The Tempest,20000000,277943,277943,-19722057,2010
2010-10-12,3242,The Fighter,11000000,129262388,93617009,118262388,2010
2010-10-15,794,Red,60000000,196439693,90380162,136439693,2010
2010-10-15,1075,Hereafter,50000000,105246941,32746941,55246941,2010
2010-10-15,2316,Jackass 3D,20000000,171685793,117229692,151685793,2010
2010-10-15,2646,Carlos,18000000,157002,145526,-17842998,2010
2010-10-15,3107,Conviction,12500000,11826980,6797696,-673020,2010
2010-10-15,4697,N-Secure,1600000,2595644,2595644,995644,2010
2010-10-15,5130,I Want Your Money,400000,433588,433588,33588,2010
2010-10-15,5351,Down Terrace,30000,9812,9812,-20188,2010
2010-10-20,4331,Paranormal Activity 2,3000000,177512032,84752907,174512032,2010
2010-10-29,2678,Saw 3D,17000000,133735284,45710178,116735284,2010
2010-10-29,3456,Welcome to the Rileys,10000000,355919,152857,-9644081,2010
2010-10-29,3656,Wild Target,8000000,5314194,109338,-2685806,2010
2010-10-29,5069,Monsters,500000,5639730,237301,5139730,2010
2010-11-05,2776,Haeundae,16000000,64733391,0,48733391,2010
2010-11-06,298,The A-Team,110000000,177241171,77222099,67241171,2010
2010-11-06,1278,The Karate Kid,40000000,351774938,176591618,311774938,2010
2010-11-06,4562,Winter's Bone,2000000,16131551,6531503,14131551,2010
2010-11-06,4616,Jerusalema,2000000,10679,7294,-1989321,2010
2010-11-19,235,Harry Potter and the Deathly Hallows: Part I,125000000,960283305,295983305,835283305,2010
2010-11-19,1806,The Next Three Days,30000000,67255916,21148651,37255916,2010
2010-11-19,3644,Made in Dagenham,8000000,15644196,1095369,7644196,2010
2010-11-24,8,Tangled,260000000,586581936,200821936,326581936,2010
2010-11-24,433,The Nutcracker in 3D,90000000,20466016,195459,-69533984,2010
2010-11-24,945,Burlesque,55000000,90552675,39440655,35552675,2010
2010-11-24,1789,Love and Other Drugs,30000000,102716321,32367005,72716321,2010
2010-11-24,2183,Faster,24000000,35792945,23240020,11792945,2010
2010-11-26,2792,The King’s Speech,15000000,430821168,138797449,415821168,2010
2010-12-02,167,The Wolfman,150000000,142634358,62189884,-7365642,2010
2010-12-02,374,Percy Jackson & the Olympians: The Lightning Thief,95000000,223050874,88768303,128050874,2010
2010-12-02,990,Valentine's Day,52000000,217569328,110485654,165569328,2010
2010-12-02,3586,My Name is Khan,8470000,42355526,4046336,33885526,2010
2010-12-03,359,Green Zone,100000000,97523020,35497337,-2476980,2010
2010-12-03,2373,She's Out of My League,20000000,48680977,32010860,28680977,2010
2010-12-03,2747,Remember Me,16000000,56506120,19068240,40506120,2010
2010-12-03,2981,Our Family Wedding,14000000,21410546,20255281,7410546,2010
2010-12-03,5343,The Exploding Girl,40000,25572,25572,-14428,2010
2010-12-11,376,Unstoppable,95000000,169511609,81562942,74511609,2010
2010-12-11,3355,Skyline,10000000,78693371,21416355,68693371,2010
2010-12-11,5331,Tiny Furniture,50000,424149,391674,374149,2010
2010-12-17,51,Tron: Legacy,200000000,400062763,172062763,200062763,2010
2010-12-17,270,How Do You Know?,120000000,49628177,30212620,-70371823,2010
2010-12-17,510,Yogi Bear,80000000,204774690,100246011,124774690,2010
2010-12-17,3111,Casino Jack,12500000,2272186,2039869,-10227814,2010
2010-12-17,4046,Rabbit Hole,5000000,6205034,2229058,1205034,2010
2010-12-22,332,Little Fockers,100000000,310650574,148438600,210650574,2010
2010-12-22,1512,True Grit,35000000,252276928,171243005,217276928,2010
2010-12-22,2862,Country Strong,15000000,20601987,20218921,5601987,2010
2010-12-22,3758,Somewhere,7000000,17023121,1785645,10023121,2010
2010-12-25,281,Gulliver's Travels,112000000,232017848,42779261,120017848,2010
2010-12-25,2706,L'illusionniste,17000000,8609949,2231474,-8390051,2010
2010-12-29,3640,Another Year,8000000,20005613,3205706,12005613,2010
2010-12-29,4853,Blue Valentine,1000000,16566240,9737892,15566240,2010
2010-12-31,1855,Konferenz der Tiere,30000000,53048539,0,23048539,2010
2010-12-31,2154,Sammy's avonturen: De geheime doorgang,25000000,71594792,0,46594792,2010
2010-12-31,2155,Belka i Strelka. Zvezdnye sobaki,25000000,9445081,0,-15554919,2010
2010-12-31,3476,The Reef,10000000,15037867,0,5037867,2010
2010-12-31,3509,Mine Vaganti,9100000,18872126,0,9772126,2010
2010-12-31,4079,Psych 9,5000000,0,0,-5000000,2010
2010-12-31,4502,Christmas Mail,2500000,0,0,-2500000,2010
2010-12-31,4539,Lies in Plain Sight,2100000,0,0,-2100000,2010
2010-12-31,4836,Dead Undead The,1100000,0,0,-1100000,2010
2010-12-31,4954,Trance,950000,0,0,-950000,2010
2010-12-31,5088,Drones,500000,0,0,-500000,2010
2010-12-31,5181,Anderson's Cross,300000,0,0,-300000,2010
2010-12-31,5183,Death Calls,290000,0,0,-290000,2010
2010-12-31,5209,The Christmas Bunny,250000,0,0,-250000,2010
2010-12-31,5213,Butterfly,250000,0,0,-250000,2010
2011-01-04,760,Hop,63000000,188657593,108085305,125657593,2010
2011-01-04,1669,Source Code,32000000,140428499,54712227,108428499,2010
2011-01-04,3027,The Last Godfather,13400000,164247,164247,-13235753,2010
2011-01-04,3934,Haevnen,5500000,15867314,1008098,10367314,2010
2011-01-04,4224,Trust,4000000,120016,120016,-3879984,2010
2011-01-04,4467,"Fat, Sick & Nearly Dead",2600000,0,0,-2600000,2010
2011-01-04,4491,Super,2500000,593933,327716,-1906067,2010
2011-01-04,4706,Insidious,1500000,99870886,54009150,98370886,2010
2011-01-04,5073,Rubber,500000,680914,100370,180914,2010
2011-01-07,1786,Larry Crowne,30000000,61449135,35608245,31449135,2010
2011-01-07,2394,Monte Carlo,20000000,39686769,23186769,19686769,2010
2011-01-07,4908,The Perfect Host,1000000,51587,48764,-948413,2010
2011-01-14,295,The Green Hornet,110000000,229155503,98780042,119155503,2010
2011-01-14,664,The Dilemma,70000000,70546865,48475290,546865,2010
2011-01-14,1839,Barney's Version,30000000,8845575,7502560,-21154425,2010
2011-01-14,4252,Down for Life,3800000,41914,41914,-3758086,2010
2011-01-21,2030,No Strings Attached,25000000,149228078,70662220,124228078,2010
2011-01-28,1245,The Mechanic,42500000,76347393,29121498,33847393,2010
2011-01-28,1485,The Rite,37000000,97143987,33047633,60143987,2010
2011-01-28,1619,Biutiful,35000000,24687524,5101237,-10312476,2010
2011-02-09,2093,Shark Night 3D,25000000,32209741,18877153,7209741,2010
2011-02-09,3995,Apollo 18,5000000,26517819,17686929,21517819,2010
2011-02-09,4127,Salvando al Soldado Perez,4500000,9330465,1400726,4830465,2010
2011-02-12,3812,Shame,6500000,20412841,4002293,13912841,2010
2011-02-18,1043,I am Number Four,50000000,146195159,55100437,96195159,2010
2011-02-18,1321,Unknown,40000000,136123083,63686397,96123083,2010
2011-02-18,1673,"Big Mommas: Like Father, Like Son",32000000,82332450,37915414,50332450,2010
2011-02-25,693,Hall Pass,68000000,87173475,45060734,19173475,2010
2011-02-25,1105,Drive Angry,50000000,41042583,10721033,-8957417,2010
2011-02-25,4040,Des Hommes et Des Dieux,5000000,46263525,3954651,41263525,2010
2011-02-25,5233,The Grace Card,200000,2430735,2430735,2230735,2010
2011-02-26,3563,Ultramarines,8900000,0,0,-8900000,2010
2011-03-06,121,X-Men: First Class,160000000,355408305,146408305,195408305,2010
2011-03-06,4324,Beginners,3200000,14314407,5790894,11114407,2010
2011-03-06,4654,Submarine,1900000,4581937,467602,2681937,2010
2011-03-06,4749,The Lion of Judah,1500000,0,0,-1500000,2010
2011-03-15,3900,A Shine of Rainbows,6000000,0,0,-6000000,2010
2011-03-18,1325,The Lincoln Lawyer,40000000,87145086,58009200,47145086,2010
2011-03-18,1357,Paul,40000000,101162106,37412945,61162106,2010
2011-03-18,1937,Limitless,27000000,155564919,79249455,128564919,2010
2011-03-18,3908,Winter in Wartime,5800000,9662214,542860,3862214,2010
2011-03-25,606,Sucker Punch,75000000,89758389,36392502,14758389,2010
2011-03-25,2580,Diary of a Wimpy Kid: Rodrick Rules,18000000,73695194,52698535,55695194,2010
2011-03-25,3884,The 5th Quarter,6000000,408159,408159,-5591841,2010
2011-04-02,1803,Sanctum,30000000,104283753,23209310,74283753,2010
2011-04-02,2736,The Roommate,16000000,52545707,37300107,36545707,2010
2011-04-03,203,Rango,135000000,245504574,123257581,110504574,2010
2011-04-03,1000,The Adjustment Bureau,50200000,126931325,62495645,76731325,2010
2011-04-03,2550,Take Me Home Tonight,19000000,7576604,6928068,-11423396,2010
2011-04-03,2686,Beastly,17000000,38028230,27865571,21028230,2010
2011-04-03,3888,Akmareul Boatda,6000000,13168809,129210,7168809,2010
2011-04-10,2156,La véritable histoire du Chat Botté,25000000,8208594,0,-16791406,2010
2011-04-11,455,Tower Heist,85000000,150422946,78046570,65422946,2010
2011-04-11,2364,A Very Harold & Kumar 3D Christmas,20000000,36265745,35061031,16265745,2010
2011-04-11,2937,The Son of No One,15000000,1148578,30680,-13851422,2010
2011-04-15,401,Rio,90000000,487519809,143619809,397519809,2010
2011-04-15,1354,Scream 4,40000000,95989590,38180928,55989590,2010
2011-04-15,2118,The Conspirator,25000000,15907411,11538204,-9092589,2010
2011-04-22,1453,Water for Elephants,38000000,116809717,58709717,78809717,2010
2011-04-22,2038,Madea's Big Happy Family,25000000,53345287,53345287,28345287,2010
2011-04-22,3951,Dum Maaro Dum,5200000,11633427,564489,6433427,2010
2011-04-22,4228,Stake Land,4000000,679482,33245,-3320518,2010
2011-04-22,4671,POM Wonderful Presents: The Greatest Movie Ever Sold,1800000,783733,638476,-1016267,2010
2011-04-29,238,Fast Five,125000000,629969804,209837675,504969804,2010
2011-04-29,1834,Hoodwinked Too: Hood vs. Evil,30000000,23353111,10143779,-6646889,2010
2011-04-29,2494,Dylan Dog: Dead of Night,20000000,6093725,1186538,-13906275,2010
2011-04-29,3629,Prom,8000000,10763183,10130219,2763183,2010
2011-05-08,388,Rise of the Planet of the Apes,93000000,482860185,176760185,389860185,2010
2011-05-08,992,The Change-Up,52000000,75835124,37081475,23835124,2010
2011-05-13,856,Priest,60000000,84154026,29136626,24154026,2010
2011-05-13,1658,Bridesmaids,32500000,289527030,169106725,257027030,2010
2011-05-13,3770,Hesher,7000000,382946,382946,-6617054,2010
2011-05-13,4044,Everything Must Go,5000000,2821010,2712131,-2178990,2010
2011-05-13,4508,Go For It!,2450000,182358,180237,-2267642,2010
2011-05-20,17,Pirates of the Caribbean: On Stranger Tides,250000000,1045663875,241063875,795663875,2010
2011-05-20,1750,Midnight in Paris,30000000,162838373,56816662,132838373,2010
2011-05-24,4780,Forget Me Not,1300000,13465,0,-1286535,2010
2011-05-26,152,Kung Fu Panda 2,150000000,664837547,165249063,514837547,2010
2011-05-26,487,The Hangover Part II,80000000,586464305,254464305,506464305,2010
2011-05-27,1600,The Tree of Life,35000000,61721826,13305665,26721826,2010
2011-05-27,3704,Die Welle,7250000,35122948,0,27872948,2010
2011-06-05,148,Thor,150000000,449326618,181030624,299326618,2010
2011-06-05,1505,There Be Dragons,36000000,4020990,1069334,-31979010,2010
2011-06-05,1552,Something Borrowed,35000000,65084116,39046489,30084116,2010
2011-06-05,2300,The Beaver,21000000,5046038,970816,-15953962,2010
2011-06-05,3713,Jumping the Broom,7000000,38158601,37295394,31158601,2010
2011-06-05,4395,Hobo with a Shotgun,3000000,834953,703372,-2165047,2010
2011-06-17,54,Green Lantern,200000000,219535492,116601172,19535492,2010
2011-06-17,930,Mr. Poppers's Penguins,55000000,189624452,68224452,134624452,2010
2011-06-17,4205,The Art of Getting By,4000000,1989035,1430241,-2010965,2010
2011-06-21,3479,You Got Served: Beat The World,10000000,1230542,0,-8769458,2010
2011-06-24,50,Cars 2,200000000,560155383,191450875,360155383,2010
2011-06-24,2530,Bad Teacher,19000000,215448997,100292856,196448997,2010
2011-06-24,3430,A Better Life,10000000,1884251,1759252,-8115749,2010
2011-06-24,4110,Le nom des gens,4600000,9261711,514237,4661711,2010
2011-06-28,4296,2:13,3500000,0,0,-3500000,2010
2011-06-29,56,Transformers: Dark of the Moon,195000000,1123790543,352390543,928790543,2010
2011-07-01,1384,Season of the Witch,40000000,91126600,24827228,51126600,2010
2011-07-10,297,Real Steel,110000000,263880341,85463309,153880341,2010
2011-07-10,1852,Xinhai geming,30000000,8593154,135739,-21406846,2010
2011-07-10,2203,The Ides of March,23000000,77735925,40962534,54735925,2010
2011-07-10,4133,Blackthorn,4500000,1217307,200558,-3282693,2010
2011-07-15,231,Harry Potter and the Deathly Hallows: Part II,125000000,1341511219,381011219,1216511219,2010
2011-07-15,1798,Winnie the Pooh,30000000,50145607,26692846,20145607,2010
2011-07-15,3880,Snow Flower and the Secret Fan,6000000,11348205,1348205,5348205,2010
2011-07-15,3937,Salvation Boulevard,5500000,28468,28468,-5471532,2010
2011-07-22,184,Captain America: The First Avenger,140000000,370569776,176654505,230569776,2010
2011-07-22,1538,Friends with Benefits,35000000,146595891,55802754,111595891,2010
2011-07-22,2954,Elle s'appelait Sarah,14500000,25480031,7691700,10980031,2010
2011-07-22,5262,Another Earth,175000,2102779,1321194,1927779,2010
2011-07-29,114,Cowboys and Aliens,163000000,175910315,100240551,12910315,2010
2011-07-29,286,The Smurfs,110000000,563749323,142614158,453749323,2010
2011-07-29,1024,"Crazy, Stupid, Love",50000000,147142328,84351197,97142328,2010
2011-07-29,2526,The Devil's Double,19100000,2406666,1361512,-16693334,2010
2011-07-29,3087,Attack the Block,13000000,6459183,1024175,-6540817,2010
2011-07-29,3864,The Guard,6000000,21197454,5359774,15197454,2010
2011-07-29,4885,The Future,1000000,1239174,568662,239174,2010
2011-07-29,5041,The Harvest/La Cosecha,560000,3709,3709,-556291,2010
2011-08-04,1092,Your Highness,50000000,26121638,21596445,-23878362,2010
2011-08-04,1365,Arthur,40000000,47787943,33035397,7787943,2010
2011-08-04,1776,Hanna,30000000,65343694,40259119,35343694,2010
2011-08-04,2583,Soul Surfer,18000000,47158652,43853424,29158652,2010
2011-08-04,4587,Meek's Cutoff,2000000,1869928,977772,-130072,2010
2011-08-07,518,Zookeeper,80000000,170805525,80360866,90805525,2010
2011-08-07,1517,Horrible Bosses,35000000,212417601,117538559,177417601,2010
2011-08-07,2157,Ironclad,25000000,5297411,0,-19702589,2010
2011-08-07,5058,Sholem Aleichem: Laughing in the Darkness,500000,1131261,1131261,631261,2010
2011-08-19,430,Conan the Barbarian,90000000,63356133,21295021,-26643867,2010
2011-08-19,1815,Fright Night,30000000,40520649,18298649,10520649,2010
2011-08-19,1946,Spy Kids: All the Time in the World,27000000,80681183,38536376,53681183,2010
2011-08-19,2874,One Day,15000000,59168692,13843771,44168692,2010
2011-08-19,3222,5 Days of War,12000000,87793,17479,-11912207,2010
2011-08-19,4129,Nannerl la soeur de Mozart,4500000,2404639,707885,-2095361,2010
2011-08-19,4439,Griff the Invisible,2900000,25935,20778,-2874065,2010
2011-08-19,4735,Amigo,1500000,184705,184705,-1315295,2010
2011-08-23,4670,Higher Ground,1800000,842693,841056,-957307,2010
2011-08-26,1359,Colombiana,40000000,72295262,36665854,32295262,2010
2011-08-26,2085,Don't Be Afraid of the Dark,25000000,39126427,24046682,14126427,2010
2011-08-26,3281,Brighton Rock,11000000,229653,229653,-10770347,2010
2011-08-26,3980,Our Idiot Brother,5000000,25861249,24814830,20861249,2010
2011-08-26,4520,Redemption Road,2300000,29384,29384,-2270616,2010
2011-08-26,4963,Circumstance,900000,958978,454121,58978,2010
2011-08-31,2376,The Debt,20000000,46604054,31177548,26604054,2010
2011-09-09,802,Contagion,60000000,137551594,75658097,77551594,2010
2011-09-09,2113,Warrior,25000000,24215385,13657115,-784615,2010
2011-09-09,3425,Bucky Larson: Born to Be a Star,10000000,2529395,2529395,-7470605,2010
2011-09-09,4398,Creature,3000000,331000,331000,-2669000,2010
2011-09-09,4413,Tanner Hall,3000000,5073,5073,-2994927,2010
2011-09-09,4621,Grave Encounters,2000000,2151887,0,151887,2010
2011-09-09,4996,Kevin Hart: Laugh at My Pain,750000,7712436,7706436,6962436,2010
2011-09-11,1556,J. Edgar,35000000,84606030,37306030,49606030,2010
2011-09-12,1977,New Year’s Eve,26000000,146850273,54544638,120850273,2010
2011-09-12,2074,The Sitter,25000000,38749404,30542576,13749404,2010
2011-09-12,2294,Tinker Tailor Soldier Spy,21000000,81452811,24149393,60452811,2010
2011-09-12,3171,Young Adult,12000000,22750356,16311571,10750356,2010
2011-09-13,4423,Never Back Down 2: The Beatdown,3000000,0,0,-3000000,2010
2011-09-16,2126,Straw Dogs,25000000,11253821,10324441,-13746179,2010
2011-09-16,2188,I Don't Know How She Does It,24000000,24474463,9659074,474463,2010
2011-09-16,2829,Drive,15000000,78054825,35060689,63054825,2010
2011-09-16,3653,Restless,8000000,2772511,163753,-5227489,2010
2011-09-16,3707,3,7200000,295492,59774,-6904508,2010
2011-09-23,676,Killer Elite,70000000,65409046,25124986,-4590954,2010
2011-09-23,1030,Moneyball,50000000,111300835,75605492,61300835,2010
2011-09-23,1480,Dolphin Tale,37000000,96068724,72286779,59068724,2010
2011-09-23,1572,Abduction,35000000,86648359,28087155,51648359,2010
2011-09-23,1849,Machine Gun Preacher,30000000,3721988,538690,-26278012,2010
2011-09-23,4207,Red State,4000000,1983596,1065429,-2016404,2010
2011-09-23,5258,Weekend,190000,1577585,484592,1387585,2010
2011-09-30,1094,Dream House,50000000,41642166,21302340,-8357834,2010
2011-09-30,2431,What's Your Number?,20000000,30163785,14011084,10163785,2010
2011-09-30,3013,Margaret,14000000,623292,47185,-13376708,2010
2011-09-30,3606,50/50,8000000,41334735,35016118,33334735,2010
2011-09-30,4061,Tucker & Dale vs. Evil,5000000,5476793,223838,476793,2010
2011-09-30,4099,Take Shelter,4750000,4972016,1728953,222016,2010
2011-09-30,4542,Courageous,2000000,35185884,34522221,33185884,2010
2011-10-05,3902,The Hit List,6000000,0,0,-6000000,2010
2011-10-06,1013,Super 8,50000000,257972745,127004179,207972745,2010
2011-10-06,4286,Trolljegeren,3500000,5706638,253444,2206638,2010
2011-10-08,2009,The Help,25000000,213120004,169705587,188120004,2010
2011-10-14,1275,The Big Year,41000000,7684524,7204138,-33315476,2010
2011-10-14,1467,The Thing,38000000,27501814,16928670,-10498186,2010
2011-10-14,1628,Trespass,35000000,786532,16816,-34213468,2010
2011-10-14,2170,Footloose,24000000,62989834,51802742,38989834,2010
2011-10-14,3662,Fireflies in the Garden,8000000,3505823,36884,-4494177,2010
2011-10-21,431,The Three Musketeers,90000000,139877913,20377913,49877913,2010
2011-10-21,1223,Johnny English Reborn,45000000,164539660,8305970,119539660,2010
2011-10-21,3757,The Mighty Macs,7000000,1891936,1891936,-5108064,2010
2011-10-21,3935,Le Havre,5500000,13480196,611709,7980196,2010
2011-10-21,3956,Paranormal Activity 3,5000000,202053386,104028807,197053386,2010
2011-10-21,4158,Cargo,4200000,313230,0,-3886770,2010
2011-10-21,4305,Margin Call,3400000,20433227,5353586,17033227,2010
2011-10-21,4867,Martha Marcy May Marlene,1000000,5438911,2981038,4438911,2010
2011-10-28,217,Puss in Boots,130000000,554987477,149260504,424987477,2010
2011-10-28,1221,The Rum Diary,45000000,21544732,13109815,-23455268,2010
2011-10-28,1554,In Time,35000000,165103952,37553932,130103952,2010
2011-10-28,1936,Anonymous,27500000,15815509,4463292,-11684491,2010
2011-10-28,5189,Like Crazy,250000,3731489,3395391,3481489,2010
2011-11-02,506,Just Go With It,80000000,214974953,103028109,134974953,2010
2011-11-02,1490,Gnomeo and Juliet,36000000,193737977,99967670,157737977,2010
2011-11-02,2091,The Eagle,25000000,36054706,19490041,11054706,2010
2011-11-02,3034,Justin Bieber: Never Say Never,13000000,99034125,73013910,86034125,2010
2011-11-02,3402,Cedar Rapids,10000000,7862131,6861102,-2137869,2010
2011-11-02,4733,MOOZ-lum,1500000,372239,362239,-1127761,2010
2011-11-02,4811,Certifiably Jonathan,1200000,7826,7826,-1192174,2010
2011-11-02,5344,Raymond Did It,40000,3632,3632,-36368,2010
2011-11-03,170,Mars Needs Moms,150000000,39549758,21392758,-110450242,2010
2011-11-03,650,Battle: Los Angeles,70000000,213463976,83552429,143463976,2010
2011-11-03,1258,Red Riding Hood,42000000,91678442,37662162,49678442,2010
2011-11-03,3207,Kill the Irishman,12000000,1188194,1188194,-10811806,2010
2011-11-03,5167,3 Backyards,300000,39475,39475,-260525,2010
2011-11-11,559,Jack and Jill,79000000,150519217,74158157,71519217,2010
2011-11-11,589,Immortals,75000000,211562435,83504017,136562435,2010
2011-11-11,3503,Melancholia,9400000,21817298,3030848,12417298,2010
2011-11-16,2322,The Descendants,20000000,175507800,82624961,155507800,2010
2011-11-18,207,Happy Feet Two,135000000,157956466,64006466,22956466,2010
2011-11-18,227,"The Twilight Saga: Breaking Dawn, Part 1",127500000,689420051,281287133,561920051,2010
2011-11-18,4232,Another Happy Day,4000000,978527,9120,-3021473,2010
2011-11-23,78,Hugo,180000000,180047784,73864507,47784,2010
2011-11-23,464,Arthur Christmas,85000000,149717124,46462469,64717124,2010
2011-11-23,1170,The Muppets,45000000,160971922,88625922,115971922,2010
2011-11-23,2475,A Dangerous Method,20000000,14807531,5702083,-5192469,2010
2011-11-23,3377,My Week with Marilyn,10000000,34240572,14597405,24240572,2010
2011-11-25,2731,The Artist,16000000,128256712,44667095,112256712,2010
2011-11-25,5368,The Ridges,17300,0,0,-17300,2010
2011-12-08,1349,Final Destination 5,40000000,155011165,42587643,115011165,2010
2011-12-08,1906,30 Minutes or Less,28000000,40966716,37053924,12966716,2010
2011-12-08,3531,Glee: The 3D Concert Movie,9000000,17462398,11862398,8462398,2010
2011-12-16,173,Mission: Impossible—Ghost Protocol,145000000,694713230,209397903,549713230,2010
2011-12-16,240,Sherlock Holmes: A Game of Shadows,125000000,535663443,186848418,410663443,2010
2011-12-16,497,Alvin and the Chipmunks: Chipwrecked,80000000,349088523,133107389,269088523,2010
2011-12-16,2141,Carnage,25000000,38112154,2546747,13112154,2010
2011-12-20,406,The Girl with the Dragon Tattoo,90000000,239373970,102515793,149373970,2010
2011-12-21,223,The Adventures of Tintin,130000000,373993951,77591831,243993951,2010
2011-12-21,3690,Albert Nobbs,7500000,8539003,3014696,1039003,2010
2011-12-23,1029,We Bought a Zoo,50000000,118729073,75624550,68729073,2010
2011-12-23,3090,In The Land of Blood and Honey,13000000,509193,303877,-12490807,2010
2011-12-25,652,War Horse,70000000,156815529,79883359,86815529,2010
2011-12-25,1368,Extremely Loud and Incredibly Close,40000000,55247881,31847881,15247881,2010
2011-12-25,1632,The Darkest Hour,34800000,62831715,21443494,28031715,2010
2011-12-30,4980,Jodaeiye Nader az Simin,800000,24426169,7098492,23626169,2010
2011-12-31,3225,Tu Xia Chuan Qi,12000000,1828400,0,-10171600,2010
2011-12-31,3508,Red Dog,9100000,20927794,0,11827794,2010
2011-12-31,3819,Tracker,6500000,3149,0,-6496851,2010
2011-12-31,3901,Freaky Deaky,6000000,0,0,-6000000,2010
2011-12-31,4085,We Have Your Husband,5000000,0,0,-5000000,2010
2011-12-31,4104,Without Men,4700000,0,0,-4700000,2010
2011-12-31,4464,La Cara Oculta,2600000,7033931,0,4433931,2010
2011-12-31,4642,True Bromance,2000000,0,0,-2000000,2010
2011-12-31,5217,Rock the House,250000,0,0,-250000,2010
2011-12-31,5319,Absentia,70000,8555,0,-61445,2010
2012-01-06,102,Snow White and the Huntsman,170000000,401021746,155136755,231021746,2010
2012-01-06,3189,For Greater Glory,12000000,10026255,5669081,-1973745,2010
2012-01-06,4238,The Loved Ones,4000000,12302,0,-3987698,2010
2012-01-06,4810,"Pink Ribbons, Inc.",1200000,26608,26608,-1173392,2010
2012-01-06,4905,Hardflip,1000000,96734,96734,-903266,2010
2012-01-10,200,The Croods,135000000,573068425,187168425,438068425,2010
2012-01-13,1932,Joyful Noise,27500000,31157914,30932113,3657914,2010
2012-01-13,2031,Contraband,25000000,98406855,66528000,73406855,2010
2012-01-13,2976,The Iron Lady,14000000,115592104,29959436,101592104,2010
2012-01-13,3759,We Need to Talk About Kevin,7000000,10765283,1738692,3765283,2010
2012-01-13,4412,The Divide,3000000,156362,18000,-2843638,2010
2012-01-13,5382,Newlyweds,9000,4584,4584,-4416,2010
2012-01-20,365,Jin líng shí san chai,100000000,98227017,311434,-1772983,2010
2012-01-20,659,Underworld: Awakening,70000000,160379930,62321039,90379930,2010
2012-01-20,886,Red Tails,58000000,50365498,49876377,-7634502,2010
2012-01-20,2209,Haywire,23000000,36374700,18942396,13374700,2010
2012-01-20,3444,Coriolanus,10000000,1049641,749641,-8950359,2010
2012-01-27,1261,One for the Money,42000000,36197221,26414527,-5802779,2010
2012-01-27,1266,Man on a Ledge,42000000,45688337,18620000,3688337,2010
2012-01-27,2041,The Grey,25000000,81249176,51580136,56249176,2010
2012-02-03,698,Doctor Seuss' The Lorax,67500000,350976753,214030500,283476753,2010
2012-02-03,3137,Project X,12000000,103028188,54731865,91028188,2010
2012-02-03,4403,Tim and Eric's Billion Dollar Movie,3000000,223652,201436,-2776348,2010
2012-02-11,111,Wreck-It Ralph,165000000,496511521,189412677,331511521,2010
2012-02-11,1693,Flight,31000000,160558438,93772375,129558438,2010
2012-02-11,2775,Vamps,16000000,94812,3361,-15905188,2010
2012-02-11,2870,The Man with the Iron Fists,15000000,22018988,15634090,7018988,2010
2012-02-17,732,This Means War,65000000,156974557,54760791,91974557,2010
2012-02-17,898,Ghost Rider: Spirit of Vengeance,57000000,149217355,51774002,92217355,2010
2012-02-17,2208,Kari gurashi no Arietti,23000000,151496097,19192510,128496097,2010
2012-02-24,1661,Wanderlust,32500000,24159934,17288155,-8340066,2010
2012-02-24,2972,Tyler Perry's Good Deeds,14000000,35579177,35025791,21579177,2010
2012-02-24,3131,Act of Valor,12000000,82497035,70012847,70497035,2010
2012-03-02,1393,Big Miracle,40000000,25268680,20157300,-14731320,2010
2012-03-02,2812,The Woman in Black,15000000,128955898,54333290,113955898,2010
2012-03-02,3134,Chronicle,12000000,123681790,64575175,111681790,2010
2012-03-02,4676,Dysfunctional Friends,1800000,0,0,-1800000,2010
2012-03-02,4991,Kill List,800000,462206,29063,-337794,2010
2012-03-02,4999,The Innkeepers,750000,1011535,78396,261535,2010
2012-03-04,5089,Enter Nowhere,500000,0,0,-500000,2010
2012-03-07,26,The Amazing Spider-Man,220000000,757890267,262030663,537890267,2010
2012-03-07,5177,Some Guy Who Kills People,300000,0,0,-300000,2010
2012-03-08,249,Total Recall,125000000,211856088,58877969,86856088,2010
2012-03-08,2243,Diary of a Wimpy Kid: Dog Days,22000000,77229695,49008662,55229695,2010
2012-03-08,4976,Celeste and Jesse Forever,840000,3787689,3103407,2947689,2010
2012-03-16,1247,21 Jump Street,42000000,202812429,138447667,160812429,2010
2012-03-16,3415,"Jeff, Who Lives at Home",10000000,4708127,4269426,-5291873,2010
2012-03-16,3863,Casa de mi Padre,6000000,8446952,5909483,2446952,2010
2012-03-16,5325,The FP,60000,0,0,-60000,2010
2012-03-20,4235,A Lonely Place to Die,4000000,442550,0,-3557450,2010
2012-03-20,4935,Snow White: A Deadly Summer,1000000,0,0,-1000000,2010
2012-03-23,486,The Hunger Games,80000000,677923379,408010692,597923379,2010
2012-03-23,4826,Serbuan maut,1100000,9297407,4105123,8197407,2010
2012-03-23,4861,October Baby,1000000,5391992,5355847,4391992,2010
2012-03-30,163,Wrath of the Titans,150000000,305270083,83670083,155270083,2010
2012-03-30,457,Mirror Mirror,85000000,173613482,64935167,88613482,2010
2012-03-30,3092,Womb,13000000,0,0,-13000000,2010
2012-03-30,4633,The Legend of Hell’s Gate: An American Conspiracy,2000000,0,0,-2000000,2010
2012-04-05,22,The Avengers,225000000,1519479547,623279547,1294479547,2010
2012-04-05,3118,A Little Bit of Heaven,12500000,1100287,10011,-11399713,2010
2012-04-05,3284,LOL,11000000,10431506,0,-568494,2010
2012-04-05,3318,The Best Exotic Marigold Hotel,10000000,134639780,46383639,124639780,2010
2012-04-13,1766,The Three Stooges,30000000,54052249,44338224,24052249,2010
2012-04-13,1773,The Cabin in the Woods,30000000,70768144,42073277,40768144,2010
2012-04-13,2429,Lockout,20000000,33943049,14326865,13943049,2010
2012-04-13,3487,Detention,10000000,0,0,-10000000,2010
2012-04-13,4806,Blue Like Jazz,1200000,595018,595018,-604982,2010
2012-04-13,4957,L!fe Happens,930000,30905,30905,-899095,2010
2012-04-20,2033,The Lucky One,25000000,96633833,60457138,71633833,2010
2012-04-20,3124,Think Like a Man,12000000,113373764,91547205,101373764,2010
2012-04-20,3209,Darling Companion,12000000,1200346,793352,-10799654,2010
2012-04-27,954,The Pirates! Band of Misfits,55000000,136143605,31051126,81143605,2010
2012-04-27,1651,Safe,33000000,41495213,17142080,8495213,2010
2012-04-27,1796,The Five-Year Engagement,30000000,61623819,28700285,31623819,2010
2012-04-27,1991,The Raven,26000000,30601801,16008272,4601801,2010
2012-04-27,3858,Bernie,6000000,10106975,9204489,4106975,2010
2012-04-27,3946,Hodejegerne,5250000,20188740,1200010,14938740,2010
2012-04-27,4965,The Giant Mechanical Man,900000,7396,7396,-892604,2010
2012-04-27,5282,Sound of My Voice,135000,429448,408015,294448,2010
2012-05-07,3156,Katy Perry: Part of Me,12000000,32700439,25326071,20700439,2010
2012-05-10,1161,Taken 2,45000000,377807404,139854287,332807404,2010
2012-05-10,1439,Frankenweenie,39000000,81150788,35287788,42150788,2010
2012-05-10,3116,The Paperboy,12500000,3522153,677200,-8977847,2010
2012-05-10,3658,Wuthering Heights,8000000,2721534,100915,-5278466,2010
2012-05-10,3910,Trade of Innocents,5800000,15091,15091,-5784909,2010
2012-05-16,730,The Dictator,65000000,180148897,59650222,115148897,2010
2012-05-18,34,Battleship,209000000,305218228,65233400,96218228,2010
2012-05-18,1473,What to Expect When You're Expecting,37500000,120925697,41152203,83425697,2010
2012-05-18,3561,Polisse,8900000,22744132,176988,13844132,2010
2012-05-18,4829,Beyond the Black Rainbow,1100000,56491,56491,-1043509,2010
2012-05-18,5306,Indie Game: The Movie,100000,0,0,-100000,2010
2012-05-25,29,Men in Black 3,215000000,654213485,179020854,439213485,2010
2012-05-25,2730,Moonrise Kingdom,16000000,68582095,45512466,52582095,2010
2012-05-25,3287,Les Intouchables,10800000,484873045,13182281,474073045,2010
2012-05-25,4847,Chernobyl Diaries,1000000,42411721,18119640,41411721,2010
2012-06-01,4841,The Devil Inside,1000000,101759490,53262945,100759490,2010
2012-06-03,5047,High Road,546173,0,0,-546173,2010
2012-06-04,1041,American Reunion,50000000,236799211,56758835,186799211,2010
2012-06-04,4393,Damsels in Distress,3000000,1324299,1007535,-1675701,2010
2012-06-07,1194,Savages,45000000,80594860,47323100,35594860,2010
2012-06-15,668,Rock of Ages,70000000,61031932,38518613,-8968068,2010
2012-06-15,896,That's My Boy,57500000,58085235,36931089,585235,2010
2012-06-15,5287,Your Sister's Sister,120000,3090593,1597486,2970593,2010
2012-06-22,69,Brave,185000000,554606532,237282182,369606532,2010
2012-06-22,700,Abraham Lincoln: Vampire Hunter,67500000,137489730,37519139,69989730,2010
2012-06-22,2283,To Rome with Love,21500000,74326015,16684352,52826015,2010
2012-06-22,3399,Seeking a Friend for the End of the World,10000000,11766959,7078738,1766959,2010
2012-06-27,4663,Beasts of the Southern Wild,1800000,23265132,12795746,21465132,2010
2012-06-29,1003,Ted,50000000,556016627,218665740,506016627,2010
2012-06-29,2331,Tyler Perry's Madea's Witness Protection,20000000,66950887,65653242,46950887,2010
2012-06-29,2756,People Like Us,16000000,12519804,12431792,-3480196,2010
2012-06-29,3710,Magic Mike,7000000,170549753,113721571,163549753,2010
2012-07-09,2484,The Cold Light of Day,20000000,25361206,3763583,5361206,2010
2012-07-09,3857,The Words,6000000,16369708,11494838,10369708,2010
2012-07-09,3913,The Inbetweeners,5700000,86051320,35955,80351320,2010
2012-07-09,4396,Bachelorette,3000000,12577401,446770,9577401,2010
2012-07-09,4817,Crowsnest,1200000,0,0,-1200000,2010
2012-07-12,3891,Deadfall,6000000,1673635,66351,-4326365,2010
2012-07-12,3919,Khiladi 786,5600000,14683763,385422,9083763,2010
2012-07-13,371,Ice Age: Continental Drift,95000000,879765137,161321843,784765137,2010
2012-07-13,2655,Red Lights,17700000,14518884,49521,-3181116,2010
2012-07-13,4470,2016: Obama’s America,2500000,33349941,33349941,30849941,2010
2012-07-17,5090,Girls Gone Dead,500000,0,0,-500000,2010
2012-07-20,5,The Dark Knight Rises,275000000,1084439099,448139099,809439099,2010
2012-07-20,5225,Burn,225000,1109276,1109276,884276,2010
2012-07-27,948,The Watch,55000000,67130045,34353000,12130045,2010
2012-07-27,1647,Step Up Revolution,33000000,165552290,35074677,132552290,2010
2012-07-27,3436,Killer Joe,10000000,4659110,1291645,-5340890,2010
2012-08-06,172,Madagascar 3: Europe's Most Wanted,145000000,746921271,216391482,601921271,2010
2012-08-06,246,Prometheus,125000000,402448265,126477084,277448265,2010
2012-08-06,4998,Safety Not Guaranteed,750000,4422318,4010957,3672318,2010
2012-08-08,1741,Hope Springs,30000000,133085295,63536011,103085295,2010
2012-08-11,45,Skyfall,200000000,1110526981,304360277,910526981,2010
2012-08-15,1336,The Odd Life of Timothy Green,40000000,55249159,51853450,15249159,2010
2012-08-17,343,The Expendables 2,100000000,311979256,85028192,211979256,2010
2012-08-17,820,ParaNorman,60000000,108119662,56003051,48119662,2010
2012-08-17,3352,Sparkle,10000000,24660323,24397469,14660323,2010
2012-08-17,4094,The Awakening,4900000,6924321,95933,2024321,2010
2012-08-17,4483,Robot & Frank,2500000,4934356,3317468,2434356,2010
2012-08-17,5184,Compliance,270000,830700,319285,560700,2010
2012-08-22,2263,Hit & Run,22000000,17216955,13749300,-4783045,2010
2012-08-24,1586,Premium Rush,35000000,31393201,20275446,-3606799,2010
2012-08-24,2151,Les petits mouchoirs,25000000,48530887,205505,23530887,2010
2012-08-24,2703,The Apparition,17000000,10637281,4936819,-6362719,2010
2012-08-24,4203,Samsara,4000000,5966671,2672413,1966671,2010
2012-08-28,4816,Below Zero,1200000,0,0,-1200000,2010
2012-08-29,1984,Lawless,26000000,54393637,37397291,28393637,2010
2012-08-29,2495,The Oogieloves in the BIG Balloon Adventure,20000000,1065907,1065907,-18934093,2010
2012-08-31,2967,The Possession,14000000,82925064,49130588,68925064,2010
2012-08-31,4970,"For a Good Time, Call",850000,1386088,1251749,536088,2010
2012-09-03,7,John Carter,275000000,282778100,73058679,7778100,2010
2012-09-03,1395,A Thousand Words,40000000,20790486,18450127,-19209514,2010
2012-09-03,4551,Silent House,2000000,16610760,12739737,14610760,2010
2012-09-10,4936,Truth or Die,1000000,0,0,-1000000,2010
2012-09-11,708,Lincoln,65000000,273346281,182207973,208346281,2010
2012-09-11,2163,Dangerous Liaisons,24200000,10447579,17000,-13752421,2010
2012-09-11,4242,Replicas,4000000,0,0,-4000000,2010
2012-09-11,5169,Nothing But a Man,300000,17241,17241,-282759,2010
2012-09-14,738,Resident Evil: Retribution,65000000,238940997,42345531,173940997,2010
2012-09-14,1474,The Master,37500000,58792011,16247159,21292011,2010
2012-09-14,1627,Stolen,35000000,17967746,289773,-17032254,2010
2012-09-14,3184,Arbitrage,12000000,35830713,7919574,23830713,2010
2012-09-14,4108,Barfi,4600000,36751984,2804874,32151984,2010
2012-09-14,4818,Airborne,1200000,0,0,-1200000,2010
2012-09-21,846,Trouble with the Curve,60000000,47818913,35763137,-12181087,2010
2012-09-21,1220,Dredd,45000000,41467606,13414714,-3532394,2010
2012-09-21,2822,End of Watch,15000000,57586606,41003371,42586606,2010
2012-09-21,3062,The Perks of Being a Wallflower,13000000,33069303,17742948,20069303,2010
2012-09-21,3789,House at the End of the Street,6900000,44103982,31611916,37203982,2010
2012-09-28,447,Hotel Transylvania,85000000,378505812,148313048,293505812,2010
2012-09-28,1735,Looper,30000000,170466405,66486205,140466405,2010
2012-09-28,2551,Won't Back Down,19000000,5714913,5310554,-13285087,2010
2012-09-28,2674,Pitch Perfect,17000000,116044347,65001093,99044347,2010
2012-09-28,5072,The Other Dream Team,500000,314444,134109,-185556,2010
2012-10-02,449,Safe House,85000000,208542162,126181630,123542162,2010
2012-10-02,558,Journey 2: The Mysterious Island,79000000,318146162,103860290,239146162,2010
2012-10-02,1709,The Vow,30000000,197618160,125014030,167618160,2010
2012-10-08,247,The Bourne Legacy,125000000,280355920,113203870,155355920,2010
2012-10-08,375,The Campaign,95000000,104907746,86907746,9907746,2010
2012-10-17,4210,Holy Motors,4000000,4230426,641054,230426,2010
2012-10-19,1576,Alex Cross,35000000,35426759,25888412,426759,2010
2012-10-19,3963,Paranormal Activity 4,5000000,140619520,53900335,135619520,2010
2012-10-19,4612,The First Time ,2000000,17061,17061,-1982939,2010
2012-10-19,4859,The Sessions,1000000,11495204,6002451,10495204,2010
2012-10-26,325,Cloud Atlas,102000000,130673154,27108272,28673154,2010
2012-10-26,2415,Silent Hill: Revelation 3D,20000000,55975672,17530219,35975672,2010
2012-10-26,2473,Chasing Mavericks,20000000,8300821,6002756,-11699179,2010
2012-10-26,2996,Fun Size ,14000000,11166615,9409538,-2833385,2010
2012-10-26,4073,Mientras duermes,5000000,9109597,0,4109597,2010
2012-10-26,4619,The Ghastly Love of Johnny X,2000000,2436,2436,-1997564,2010
2012-11-05,165,Dark Shadows,150000000,238202668,79727149,88202668,2010
2012-11-07,4153,Snabba Cash,4300000,10212403,188870,5912403,2010
2012-11-13,3505,Jab Tak Hai Jaan,9200000,5806666,3047539,-3393334,2010
2012-11-16,199,"The Twilight Saga: Breaking Dawn, Part 2",136200000,829724737,292324737,693524737,2010
2012-11-16,1123,Anna Karenina,49000000,71004627,12816367,22004627,2010
2012-11-16,2284,Silver Linings Playbook,21000000,236412453,132092958,215412453,2010
2012-11-16,3282,Le prénom,11000000,25307405,61611,14307405,2010
2012-11-21,177,Rise of the Guardians,145000000,306900902,103412758,161900902,2010
2012-11-21,258,Life of Pi,120000000,607987022,124987022,487987022,2010
2012-11-21,735,Red Dawn,65000000,48164150,44806783,-16835850,2010
2012-11-23,2523,De rouille et d’os,19500000,29393634,2061449,9893634,2010
2012-11-30,2872,Killing Them Softly,15000000,39238443,14945541,24238443,2010
2012-11-30,3403,The Collection,10000000,8890094,6810754,-1109906,2010
2012-12-10,1231,Argo,44500000,227140757,136025503,182640757,2010
2012-12-10,1255,Here Comes the Boom,42000000,73239258,45290318,31239258,2010
2012-12-10,3022,Seven Psychopaths,13500000,33035736,15024049,19535736,2010
2012-12-10,3418,Atlas Shrugged: Part II,10000000,3336053,3336053,-6663947,2010
2012-12-10,4335,Sinister,3000000,87727807,48086903,84727807,2010
2012-12-10,5238,Middle of Nowhere,200000,236806,236806,36806,2010
2012-12-14,13,The Hobbit: An Unexpected Journey,250000000,1017003568,303003568,767003568,2010
2012-12-18,5211,The Frozen,250000,0,0,-250000,2010
2012-12-19,986,Zero Dark Thirty,52500000,134612435,95720716,82112435,2010
2012-12-19,1358,The Guilt Trip,40000000,41294674,37134215,1294674,2010
2012-12-19,3493,Amour,9700000,36787044,6738954,27087044,2010
2012-12-21,799,Jack Reacher,60000000,217370736,80070736,157370736,2010
2012-12-21,1394,The Impossible,40000000,169590606,19019882,129590606,2010
2012-12-21,1528,This is 40,35000000,90221182,67544505,55221182,2010
2012-12-21,2115,Cirque du Soleil: Worlds Away,25000000,28012862,12512862,3012862,2010
2012-12-25,331,Django Unchained,100000000,449948323,162805434,349948323,2010
2012-12-25,712,Les Miserables,65000000,442169052,148809770,377169052,2010
2012-12-25,2025,Parental Guidance,25000000,120832383,77267296,95832383,2010
2012-12-31,566,Astérix et Obélix: Au service de Sa Majesté ,77600000,60680125,0,-16919875,2010
2012-12-31,1230,Foodfight!,45000000,73706,0,-44926294,2010
2012-12-31,2511,Zambezia,20000000,34454631,0,14454631,2010
2012-12-31,4086,Should've Been Romeo,5000000,0,0,-5000000,2010
2012-12-31,4243,The Helpers,4000000,0,0,-4000000,2010
2012-12-31,4246,How to Fall in Love,4000000,0,0,-4000000,2010
2012-12-31,4538,Infected,2100000,0,0,-2100000,2010
2012-12-31,4634,Highway,2000000,0,0,-2000000,2010
2012-12-31,4974,Snitch,850000,0,0,-850000,2010
2012-12-31,5021,After,650000,0,0,-650000,2010
2012-12-31,5098,El rey de Najayo,500000,0,0,-500000,2010
2012-12-31,5326,Hayride,60000,0,0,-60000,2010
2013-01-02,962,Bullet to the Head,55000000,22597969,9489829,-32402031,2010
2013-01-02,1736,Warm Bodies,30000000,115121608,66380662,85121608,2010
2013-01-02,3560,A Haunting in Connecticut 2: The Ghosts of Georgia,9000000,0,0,-9000000,2010
2013-01-02,4720,The Gatekeepers,1500000,2592308,2408553,1092308,2010
2013-01-03,58,Jack the Giant Slayer,195000000,197687603,65187603,2687603,2010
2013-01-03,2642,Phantom,18000000,1199510,1034589,-16800490,2010
2013-01-03,3055,21 and Over,13000000,42195766,25682380,29195766,2010
2013-01-03,3117,Ernest et Celestine,12500000,9376444,292562,-3123556,2010
2013-01-03,3204,Stoker,12000000,12079308,1703125,79308,2010
2013-01-03,4140,The Sweeney,4500000,7838405,26345,3338405,2010
2013-01-03,4175,The Last Exorcism Part II,4000000,25448707,15179303,21448707,2010
2013-01-03,4488,The Lost Medallion: The Adventures of Billy Stone,2500000,549632,549632,-1950368,2010
2013-01-04,4624,Stitches,2000000,63555,0,-1936445,2010
2013-01-11,302,Ender's Game,110000000,127983283,61737191,17983283,2010
2013-01-11,937,Free Birds,55000000,110387072,55750480,55387072,2010
2013-01-11,3172,About Time,12000000,89309178,15323921,77309178,2010
2013-01-11,3975,Dallas Buyers Club,5000000,60611845,27298285,55611845,2010
2013-01-15,4425,30 Nights Of Paranormal Activity With The Devil Inside The Girl With The Dragon Tattoo,3000000,0,0,-3000000,2010
2013-01-18,1587,Broken City,35000000,34480045,19701164,-519955,2010
2013-01-18,1829,The Last Stand,30000000,48330757,12050299,18330757,2010
2013-01-18,2803,Mama,15000000,148095566,71628180,133095566,2010
2013-01-25,1042,Hansel & Gretel: Witch Hunters,50000000,214949716,55703475,164949716,2010
2013-01-25,1594,Parker,35000000,48543388,17616641,13543388,2010
2013-01-25,3391,Movie 43,10000000,31164747,8840453,21164747,2010
2013-01-25,5324,Supporting Characters,60000,4917,4917,-55083,2010
2013-01-28,1893,Last Vegas,28000000,112914167,63914167,84914167,2010
2013-01-29,4297,"Batman: The Dark Knight Returns, Part 2",3500000,0,0,-3500000,2010
2013-02-07,6,The Lone Ranger,275000000,260002115,89302115,-14997885,2010
2013-02-08,771,2 Guns,61000000,132493015,75612460,71493015,2010
2013-02-08,4479,The Spectacular Now,2500000,6916951,6852971,4416951,2010
2013-02-08,5199,The Canyons,250000,62375,59671,-187625,2010
2013-02-14,391,A Good Day to Die Hard,92000000,304249198,67349198,212249198,2010
2013-02-14,1099,Beautiful Creatures,50000000,60282876,19452138,10282876,2010
2013-02-14,1887,Safe Haven,28000000,94050951,71399120,66050951,2010
2013-02-15,1328,Escape From Planet Earth,40000000,74156610,57012977,34156610,2010
2013-02-22,2819,Snitch,15000000,57907734,42930462,42907734,2010
2013-02-22,4233,Inescapable,4000000,4327,4327,-3995673,2010
2013-02-22,4271,Dark Skies,3500000,27704111,17418667,24204111,2010
2013-02-26,3942,Tao Jie,5400000,4728896,0,-671104,2010
2013-03-05,41,Iron Man 3,200000000,1215392272,408992272,1015392272,2010
2013-03-05,3428,The Iceman,10000000,3623609,1930282,-6376391,2010
2013-03-05,3455,"Cinco de Mayo, La Batalla",10000000,173472,173472,-9826528,2010
2013-03-05,5278,Aroused,150000,0,0,-150000,2010
2013-03-07,568,Despicable Me 2,76000000,975216835,368065385,899216835,2010
2013-03-07,4471,Kevin Hart: Let Me Explain,2500000,32327255,32244051,29827255,2010
2013-03-15,1117,Upside Down,50000000,26387039,102118,-23612961,2010
2013-03-15,1679,The Incredible Burt Wonderstone,32000000,27392609,22537881,-4607391,2010
2013-03-15,3093,The Call,12800000,69821476,51872378,57021476,2010
2013-03-15,4003,Spring Breakers,5000000,31149251,14124286,26149251,2010
2013-03-19,4632,Straight A's,2000000,0,0,-2000000,2010
2013-03-22,649,Olympus Has Fallen,70000000,150562164,98927592,80562164,2010
2013-03-22,2150,On the Road,25000000,9313302,720828,-15686698,2010
2013-03-22,3061,Admission,13000000,18733666,18007317,5733666,2010
2013-03-27,187,G.I. Joe: Retaliation,140000000,375740705,122523060,235740705,2010
2013-03-29,1083,The Host,50000000,64477051,26623701,14477051,2010
2013-03-29,2858,The Place Beyond the Pines,15000000,47011449,21403519,32011449,2010
2013-04-01,2366,Texas Chainsaw 3D,20000000,47666013,34341945,27666013,2010
2013-04-01,2903,Promised Land,15000000,9300336,7597898,-5699664,2010
2013-04-01,5366,All Superheroes Must Die,20000,0,0,-20000,2010
2013-04-10,282,Gravity,110000000,695941797,274092705,585941797,2010
2013-04-10,1810,Runner Runner,30000000,60512680,19316646,30512680,2010
2013-04-10,4688,Grace Unplugged,1700000,2507159,2507159,807159,2010
2013-04-10,4939,My Last Day Without You,1000000,0,0,-1000000,2010
2013-04-10,5328,The Dirties,55000,0,0,-55000,2010
2013-04-12,2266,Out of the Furnace,22000000,15434375,11330849,-6565625,2010
2013-04-16,1432,Un monstre à Paris ,40000000,27000381,0,-12999619,2010
2013-04-17,5071,Deceptive Practice: The Mysteries and Mentors of Ricky Jay,500000,152449,152449,-347551,2010
2013-04-19,262,Oblivion,120000000,287916633,89107235,167916633,2010
2013-04-19,4726,The Lords of Salem,1500000,1541131,1165881,41131,2010
2013-04-19,4787,Filly Brown,1250000,2940411,2850357,1690411,2010
2013-04-19,4801,Home Run,1200000,2859955,2859955,1659955,2010
2013-04-26,1660,The Big Wedding,32500000,48425971,21819348,15925971,2010
2013-04-26,1979,Pain & Gain,26000000,81275291,49875291,55275291,2010
2013-04-26,2928,The Reluctant Fundamentalist,15000000,528731,528731,-14471269,2010
2013-04-26,3354,Mud,10000000,31556959,21590086,21556959,2010
2013-05-04,2676,Evil Dead,17000000,97778356,54239856,80778356,2010
2013-05-04,2767,Trance,16000000,22594052,2322593,6594052,2010
2013-05-04,4761,Eddie: The Sleepwalking Cannibal,1400000,1632,1632,-1398368,2010
2013-05-04,4966,The Brass Teapot,900000,413733,6997,-486267,2010
2013-05-07,3984,The Way Way Back,5000000,26853810,21502690,21853810,2010
2013-05-14,4937,Black Rock,1000000,0,0,-1000000,2010
2013-05-16,60,Star Trek Into Darkness,190000000,467381584,228778661,277381584,2010
2013-05-17,4301,Jagten,3450000,18309793,687185,14859793,2010
2013-05-17,4377,Frances Ha,3000000,11267511,4067398,8267511,2010
2013-05-21,4418,Open Road,3000000,47469,0,-2952531,2010
2013-05-23,320,The Hangover 3,103000000,362000072,112200072,259000072,2010
2013-05-24,119,Fast and Furious 6,160000000,789300444,238679850,629300444,2010
2013-05-24,339,Epic,100000000,262794441,107518682,162794441,2010
2013-05-24,4363,Before Midnight,3000000,23283672,8110621,20283672,2010
2013-05-31,224,After Earth,130000000,251499665,60522097,121499665,2010
2013-05-31,586,Now You See Me,75000000,342769200,117723989,267769200,2010
2013-05-31,3588,Yeh Jawaani Hai Deewani,8300000,50827466,3827466,42527466,2010
2013-05-31,3814,The East,6500000,3027956,2274649,-3472044,2010
2013-06-09,1456,Riddick,38000000,94763758,42025135,56763758,2010
2013-06-09,2936,Winnie Mandela,15000000,61847,61847,-14938153,2010
2013-06-12,2940,Khumba,15000000,20898221,0,5898221,2010
2013-06-12,3266,Inside Llewyn Davis,11000000,32943247,13248209,21943247,2010
2013-06-12,3293,The Last Days on Mars,10600000,261364,24084,-10338636,2010
2013-06-14,24,Man of Steel,225000000,667999518,291045518,442999518,2010
2013-06-14,4863,20 Feet From Stardom,1000000,5892466,4946250,4892466,2010
2013-06-21,46,Monsters University,200000000,743588329,268488329,543588329,2010
2013-06-21,61,World War Z,190000000,531514650,202359711,341514650,2010
2013-06-21,4501,Alien Uprising,2500000,0,0,-2500000,2010
2013-06-21,5341,This Is Martin Bonner,42000,0,0,-42000,2010
2013-06-25,4142,Hansel & Gretel Get Baked,4500000,0,0,-4500000,2010
2013-06-28,166,White House Down,150000000,205440387,73103784,55440387,2010
2013-06-28,1239,The Heat,43000000,229727774,159581587,186727774,2010
2013-06-28,2223,Redemption,23000000,13593473,36686,-9406527,2010
2013-06-28,5084,Detention of the Dead,500000,1778,1778,-498222,2010
2013-07-06,888,The Internship,58000000,93672764,44672764,35672764,2010
2013-07-06,4333,The Purge,3000000,91266581,64473115,88266581,2010
2013-07-08,419,Percy Jackson: Sea of Monsters,90000000,200859554,68559554,110859554,2010
2013-07-08,1477,We're the Millers,37000000,267816276,150394119,230816276,2010
2013-07-08,5178,Midnight Cabaret,300000,0,0,-300000,2010
2013-07-17,205,Turbo,135000000,286896578,83028130,151896578,2010
2013-07-19,226,R.I.P.D.,130000000,79076678,33618855,-50923322,2010
2013-07-19,477,RED 2,84000000,137162560,53262560,53162560,2010
2013-07-19,2312,The Conjuring,20000000,318000141,137400141,298000141,2010
2013-07-19,3944,Grabbers,5300000,440821,0,-4859179,2010
2013-07-19,4098,Only God Forgives,4800000,4494560,775849,-305440,2010
2013-07-19,4889,The Act of Killing,1000000,501289,486919,-498711,2010
2013-07-23,3782,Twixt,7000000,1268346,0,-5731654,2010
2013-07-26,276,The Wolverine,115000000,416456852,132556852,301456852,2010
2013-07-26,2589,Blue Jasmine,18000000,102912961,33404871,84912961,2010
2013-07-26,4658,Stranded,1900000,285593,0,-1614407,2010
2013-07-26,4719,The To Do List,1500000,4128828,3491669,2628828,2010
2013-07-31,299,The Smurfs 2,110000000,348547523,71017784,238547523,2010
2013-08-01,5086,Now is Good,500000,2141436,0,1641436,2010
2013-08-02,1515,Identity Thief,35000000,175361578,134506920,140361578,2010
2013-08-02,1792,Side Effects,30000000,66742138,32172757,36742138,2010
2013-08-02,4635,Small Apartments,2000000,0,0,-2000000,2010
2013-08-02,4656,ABCD (Any Body Can Dance),1900000,10137234,222098,8237234,2010
2013-08-03,47,Oz the Great and Powerful,200000000,490359051,234770996,290359051,2010
2013-08-03,1833,Dead Man Down,30000000,19599974,10895295,-10400026,2010
2013-08-10,4940,Zombie Hunter,1000000,0,0,-1000000,2010
2013-08-11,145,Thor: The Dark World,150000000,644602516,206362140,494602516,2010
2013-08-11,2543,The Book Thief,19000000,76086711,21488481,57086711,2010
2013-08-16,1413,Paranoia,40000000,16173593,7388654,-23826407,2010
2013-08-16,1712,Lee Daniels' The Butler,30000000,177025498,116632095,147025498,2010
2013-08-16,1911,Kick-Ass 2,28000000,63129909,28795985,35129909,2010
2013-08-16,2610,Jobs,18000000,43402515,16131410,25402515,2010
2013-08-16,4056,Ain't Them Bodies Saints,5000000,1075009,391611,-3924991,2010
2013-08-16,4498,Underdogs,2500000,35017,35017,-2464983,2010
2013-08-21,853,The Mortal Instruments: City of Bones,60000000,75965567,31165421,15965567,2010
2013-08-23,1443,Yi dai zong shi,38600000,57987299,6594959,19387299,2010
2013-08-23,2387,The World's End,20000000,47508505,26004851,27508505,2010
2013-08-23,2525,The Frozen Ground,19200000,5617460,0,-13582540,2010
2013-08-23,5064,Drinking Buddies,500000,407100,343706,-92900,2010
2013-08-23,5263,Sparrows Dance,175000,2602,2602,-172398,2010
2013-08-30,2619,Getaway,18000000,11813989,10501938,-6186011,2010
2013-08-30,3344,One Direction: This is Us,10000000,68541786,28873374,58541786,2010
2013-08-30,3966,No se Aceptan Devoluciones,5000000,100486616,44467206,95486616,2010
2013-09-07,4636,Coffee Town,2000000,0,0,-2000000,2010
2013-09-08,261,Elysium,120000000,286192091,93050117,166192091,2010
2013-09-08,1021,Disney Planes,50000000,238059569,90282580,188059569,2010
2013-09-13,1784,The Family,30000000,51078541,36918811,21078541,2010
2013-09-13,3958,Insidious Chapter 2,5000000,161921515,83586447,156921515,2010
2013-09-13,4618,Plush,2000000,28864,3080,-1971136,2010
2013-09-18,3620,Enough Said,8000000,25621449,17550872,17621449,2010
2013-09-20,1156,Prisoners,46000000,113402302,61002302,67402302,2010
2013-09-20,1461,Rush,38000000,98230839,26947624,60230839,2010
2013-09-20,2457,Battle of the Year,20000000,16723377,8888355,-3276623,2010
2013-09-20,3665,Feichang Xingyun,8000000,21970000,0,13970000,2010
2013-09-27,561,Cloudy with a Chance of Meatballs 2,78000000,274392649,119793567,196392649,2010
2013-09-27,2636,Metallica Through the Never,18000000,9082906,3419967,-8917094,2010
2013-09-27,3574,Baggage Claim,8500000,22885836,21569509,14385836,2010
2013-09-27,3925,Don Jon,5500000,41268579,24477704,35768579,2010
2013-10-05,62,The Great Gatsby,190000000,351040419,144840419,161040419,2010
2013-10-05,2894,Peeples,15000000,9307166,9177065,-5692834,2010
2013-10-18,675,Escape Plan,70000000,103735965,25135965,33735965,2010
2013-10-18,1787,Carrie,30000000,82409520,35266619,52409520,2010
2013-10-18,1996,The Fifth Estate,26000000,6154172,3254172,-19845828,2010
2013-10-18,2334,12 Years a Slave,20000000,181025343,56671993,161025343,2010
2013-10-18,3579,All is Lost,8500000,10386814,6263670,1886814,2010
2013-10-19,3228,Supesu Batorushippu Yamato,12000000,0,0,-12000000,2010
2013-10-25,2098,The Counselor,25000000,71009334,16973715,46009334,2010
2013-10-25,2797,Jackass Presents: Bad Grandpa,15000000,160903019,102003019,145903019,2010
2013-10-25,5339,A True Story,45000,0,0,-45000,2010
2013-10-25,5346,Her Cry: La Llorona Investigation,35000,0,0,-35000,2010
2013-11-01,833,Gangster Squad,60000000,104100903,46000903,44100903,2010
2013-11-01,3262,Quartet,11000000,56178935,18388357,45178935,2010
2013-11-01,4469,A Haunted House,2500000,59922558,40041683,57422558,2010
2013-11-10,915,Captain Phillips,55000000,220648184,107136417,165648184,2010
2013-11-10,2464,Machete Kills,20000000,18273009,8008161,-1726991,2010
2013-11-10,3945,La Vie d'Adèle – Chapitres 1 & 2,5250000,22937201,2450504,17687201,2010
2013-11-10,5004,All the Boys Love Mandy Lane,750000,1960521,0,1210521,2010
2013-11-10,5020,Escape from Tomorrow,650000,171962,171962,-478038,2010
2013-11-15,2672,The Best Man Holiday,17000000,72835710,70525195,55835710,2010
2013-11-15,3168,Nebraska,12000000,24761360,17654912,12761360,2010
2013-11-15,3198,La grande bellezza,12000000,29549145,2883879,17549145,2010
2013-11-15,3761,The Christmas Candle,7000000,1933829,1632000,-5066171,2010
2013-11-22,134,Frozen,150000000,1274234980,400738009,1124234980,2010
2013-11-22,211,The Hunger Games: Catching Fire,130000000,864868047,424668047,734868047,2010
2013-11-22,2247,Delivery Man,22000000,70536870,30659817,48536870,2010
2013-11-22,3142,Philomena,12000000,98963392,37709979,86963392,2010
2013-11-27,2255,Homefront,22000000,51695362,20158492,29695362,2010
2013-11-27,2663,Black Nativity,17500000,7285135,7018188,-10214865,2010
2013-11-29,1611,Mandela: Long Walk to Freedom,35000000,29890402,8323085,-5109598,2010
2013-12-04,1292,42,40000000,97470701,95020213,57470701,2010
2013-12-04,2372,Scary Movie V,20000000,78613981,32015787,58613981,2010
2013-12-04,4329,Antiviral,3100000,123407,0,-2976593,2010
2013-12-06,1664,This is the End,32000000,126539117,101470202,94539117,2010
2013-12-07,64,Pacific Rim,190000000,411002906,101802906,221002906,2010
2013-12-07,496,Grown Ups 2,80000000,247023808,133668525,167023808,2010
2013-12-07,4960,Fruitvale Station,900000,17549645,16098998,16649645,2010
2013-12-13,15,The Hobbit: The Desolation of Smaug,250000000,960366855,258366855,710366855,2010
2013-12-13,1281,American Hustle,40000000,257878294,150117807,217878294,2010
2013-12-13,1520,Saving Mr. Banks,35000000,114962525,83299761,79962525,2010
2013-12-13,2039,Tyler Perry's A Madea Christmas,25000000,52543354,52543354,27543354,2010
2013-12-18,1012,Anchorman 2: The Legend Continues,50000000,172185754,127352707,122185754,2010
2013-12-20,539,Walking with Dinosaurs,80000000,130580730,36076121,50580730,2010
2013-12-25,95,47 Ronin,175000000,151716815,38362475,-23283185,2010
2013-12-25,338,The Wolf of Wall Street,100000000,391976723,116900694,291976723,2010
2013-12-25,394,The Secret Life of Walter Mitty,91000000,188536838,58236838,97536838,2010
2013-12-25,1373,Grudge Match,40000000,69807260,29807260,29807260,2010
2013-12-25,2059,August: Osage County,25000000,50738810,37738810,25738810,2010
2013-12-31,1860,Space Pirate Captain Harlock,30000000,143490,0,-29856510,2010
2013-12-31,2276,Metegol,22000000,30051905,0,8051905,2010
2013-12-31,2555,Out of Inferno,19000000,0,0,-19000000,2010
2013-12-31,2778,Zulu,16000000,1844228,0,-14155772,2010
2013-12-31,3500,Re-Kill,9500000,0,0,-9500000,2010
2013-12-31,4234,Geograf globus propil,4000000,4454853,0,454853,2010
2013-12-31,4677,Independence Daysaster,1800000,0,0,-1800000,2010
2013-12-31,4683,Living Dark: The Story of Ted the Caver,1750000,0,0,-1750000,2010
2013-12-31,4821,The Wicked Within,1200000,0,0,-1200000,2010
2013-12-31,4837,The Vatican Exorcisms,1100000,0,0,-1100000,2010
2013-12-31,4924,Heli,1000000,552614,0,-447386,2010
2013-12-31,5024,Treachery,625000,0,0,-625000,2010
2013-12-31,5100,Bucky and the Squirrels,500000,0,0,-500000,2010
2013-12-31,5276,Speak No Evil,150000,32927,0,-117073,2010
2013-12-31,5308,Echo Dr.,100000,0,0,-100000,2010
2013-12-31,5352,Paraphobia,30000,0,0,-30000,2010
2014-01-07,5118,Mutual Friends,450000,0,0,-450000,2010
2014-01-08,97,Guardians of the Galaxy,170000000,771100771,333172112,601100771,2010
2014-01-08,1795,Get on Up,30000000,33339868,30569935,3339868,2010
2014-01-10,2772,"Men, Women and Children",16000000,1705908,705908,-14294092,2010
2014-01-17,827,Jack Ryan: Shadow Recruit,60000000,131377412,50577412,71377412,2010
2014-01-17,1738,The Nut Job,30000000,122529966,64251538,92529966,2010
2014-01-17,2013,Ride Along,25000000,153733800,134202565,128733800,2010
2014-01-17,3731,Devil's Due,7000000,36146087,15821461,29146087,2010
2014-01-24,748,"I, Frankenstein",65000000,74575290,19075290,9575290,2010
2014-01-28,3778,Snezhnaya koroleva,7000000,15206330,0,8206330,2010
2014-01-31,2618,Labor Day,18000000,14189810,13371528,-3810190,2010
2014-01-31,3610,That Awkward Moment,8000000,53068955,26068955,45068955,2010
2014-02-04,3768,Dom Hemingway,7000000,1857458,523511,-5142542,2010
2014-02-05,49,The Amazing Spider-Man 2,200000000,708996336,202853933,508996336,2010
2014-02-05,4460,Ida,2600000,15298355,3827060,12698355,2010
2014-02-05,5031,Water & Power,600000,42557,42557,-557443,2010
2014-02-07,1794,Deliver Us from Evil,30000000,87956618,30577122,57956618,2010
2014-02-07,2320,Tammy,20000000,93931360,84525432,73931360,2010
2014-02-07,3047,Earth to Echo,13000000,42174545,38934842,29174545,2010
2014-02-14,870,Winter's Tale,60000000,22468620,12600231,-37531380,2010
2014-02-14,2392,Endless Love,20000000,34718173,23438250,14718173,2010
2014-02-14,3043,About Last Night,13000000,50445860,48637684,37445860,2010
2014-02-21,543,Pompeii,80000000,108469033,23169033,28469033,2010
2014-02-21,1910,3 Days to Kill,28000000,38959900,30697999,10959900,2010
2014-02-28,1019,Non-Stop,50000000,222383055,91742160,172383055,2010
2014-02-28,2237,Son of God,22000000,70949793,59700064,48949793,2010
2014-02-28,4687,The Lunchbox,1700000,12231500,4231500,10531500,2010
2014-03-01,3972,Paranormal Activity: The Marked Ones,5000000,86362372,32462372,81362372,2010
2014-03-10,768,Gone Girl,61000000,368567189,167767189,307567189,2010
2014-03-10,2753,Left Behind,16000000,20769209,14019924,4769209,2010
2014-03-10,3229,Drive Hard,12000000,0,0,-12000000,2010
2014-03-10,3800,Annabelle,6500000,256873813,84273813,250373813,2010
2014-03-10,4759,La chambre bleue,1400000,1945420,260441,545420,2010
2014-03-12,2826,Wild,15000000,52501541,37880356,37501541,2010
2014-03-14,705,Need for Speed,66000000,194169619,43568507,128169619,2010
2014-03-14,3395,Bad Words,10000000,7843145,7779614,-2156855,2010
2014-03-14,3873,Veronica Mars,6000000,3485383,3322127,-2514617,2010
2014-03-14,5248,The Word,200000,3648,3648,-196352,2010
2014-03-21,446,Divergent,85000000,276014965,150947895,191014965,2010
2014-03-21,941,Muppets Most Wanted,55000000,79312301,51178893,24312301,2010
2014-03-21,1998,Blood Ties,26000000,2923959,42472,-23076041,2010
2014-03-21,3438,50 to 1,10000000,1069454,1069454,-8930546,2010
2014-03-21,4822,God’s Not Dead,1150000,63777092,60755732,62627092,2010
2014-03-21,5303,Cheap Thrills,100000,59424,59424,-40576,2010
2014-03-28,222,Noah,130000000,352831065,101200044,222831065,2010
2014-03-28,1605,Sabotage,35000000,18376443,10508518,-16623557,2010
2014-03-28,5173,Locker 13,300000,3496,3496,-296504,2010
2014-04-03,4299,Wicked Blood,3500000,0,0,-3500000,2010
2014-04-04,99,Captain America: The Winter Soldier,170000000,714401889,259746958,544401889,2010
2014-04-04,3028,Under the Skin,13300000,7229933,2614251,-6070067,2010
2014-04-09,4141,Falcon Rising,4500000,11774,11774,-4488226,2010
2014-04-16,3125,Heaven is for Real,12000000,100919111,91386097,88919111,2010
2014-04-18,362,Transcendence,100000000,103039258,23022309,3039258,2010
2014-04-18,4174,A Haunted House 2,4000000,21206861,17329487,17206861,2010
2014-04-25,1303,The Other Woman,40000000,195111193,83911193,155111193,2010
2014-04-25,1915,Brick Mansions,28000000,73421224,20396829,45421224,2010
2014-04-25,5123,Blue Ruin,420000,435168,258384,15168,2010
2014-05-09,1641,Thunder and the House of Magic,34000000,10392666,4091,-23607334,2010
2014-05-09,4519,Frontera,2300000,59696,59696,-2240304,2010
2014-05-11,112,Interstellar,165000000,668913307,188017894,503913307,2010
2014-05-12,4082,Dying of the Light,5000000,0,0,-5000000,2010
2014-05-16,120,Godzilla,160000000,529076069,200676069,369076069,2010
2014-05-16,2061,Million Dollar Arm,25000000,39217912,36447959,14217912,2010
2014-05-16,2768,The Immigrant,16000000,7585011,2013456,-8414989,2010
2014-05-23,48,X-Men: Days of Future Past,200000000,747862775,233921534,547862775,2010
2014-05-23,1196,Blended,45000000,127990741,46290741,82990741,2010
2014-05-30,73,Maleficent,180000000,758536735,241407328,578536735,2010
2014-05-30,1348,A Million Ways to Die in The West,40000000,86778557,42720965,46778557,2010
2014-06-02,1237,The Interview,44000000,12342632,6105175,-31657368,2010
2014-06-06,82,Edge of Tomorrow,178000000,370541256,100206256,192541256,2010
2014-06-06,3122,The Fault in Our Stars,12000000,307166834,124872350,295166834,2010
2014-06-06,4149,Anna,4357373,1200000,0,-3157373,2010
2014-06-06,4866,Obvious Child,1000000,3324070,3122616,2324070,2010
2014-06-06,5203,Test,250000,18823,18823,-231177,2010
2014-06-13,174,How to Train Your Dragon 2,145000000,616102924,177002924,471102924,2010
2014-06-13,1004,22 Jump Street,50000000,331333876,191719337,281333876,2010
2014-06-13,3583,The Rover,8500000,3180252,1109199,-5319748,2010
2014-06-13,4778,Los insolitos peces gato,1300000,16653,11278,-1283347,2010
2014-06-17,3557,Beneath Hill 60,9000000,3440939,0,-5559061,2010
2014-06-19,5304,The Past is a Grotesque Animal,100000,20056,20056,-79944,2010
2014-06-20,1343,Jersey Boys,40000000,65282732,47047013,25282732,2010
2014-06-20,2168,Think Like a Man Too,24000000,70027933,65028687,46027933,2010
2014-06-24,4942,A Fine Step,1000000,0,0,-1000000,2010
2014-06-27,31,Transformers: Age of Extinction,210000000,1104039076,245439076,894039076,2010
2014-06-27,1420,Snowpiercer,40000000,88069880,4563029,48069880,2010
2014-06-27,3623,Begin Again,8000000,68838736,16170632,60838736,2010
2014-06-27,4417,They Came Together,3000000,82780,0,-2917220,2010
2014-07-01,4938,Hidden Away,1000000,0,0,-1000000,2010
2014-07-02,654,The Monuments Men,70000000,158702748,78031620,88702748,2010
2014-07-02,774,The Lego Movie,60000000,457729388,257784718,397729388,2010
2014-07-02,3488,Nurse 3D,10000000,0,0,-10000000,2010
2014-07-03,176,Mr. Peabody & Sherman,145000000,269806430,111506430,124806430,2010
2014-07-03,292,300: Rise of an Empire,110000000,330780051,106580051,220780051,2010
2014-07-03,1697,The Grand Budapest Hotel,31000000,164350409,59076019,133350409,2010
2014-07-03,4213,The Face of Love,4000000,1158877,385069,-2841123,2010
2014-07-11,109,Big Hero 6,165000000,652127828,222527828,487127828,2010
2014-07-11,2828,The Theory of Everything,15000000,123327692,35893537,108327692,2010
2014-07-11,3467,Elsa & Fred,10000000,109144,67657,-9890856,2010
2014-07-11,4143,Fugly,4500000,0,0,-4500000,2010
2014-07-18,1039,Planes: Fire and Rescue,50000000,156399644,59157732,106399644,2010
2014-07-18,1353,Sex Tape,40000000,126069509,38543473,86069509,2010
2014-07-18,3513,The Purge: Anarchy,9000000,111534881,71562550,102534881,2010
2014-07-18,3871,Wish I Was Here,6000000,6591365,3591299,591365,2010
2014-07-18,4893,I Origins,1000000,852399,336472,-147601,2010
2014-07-18,5284,An American in Hollywood,125000,0,0,-125000,2010
2014-07-25,346,Hercules,100000000,243388614,72688614,143388614,2010
2014-07-25,1283,Lucy,40000000,457507776,126573960,417507776,2010
2014-07-25,2613,And So It Goes,18000000,17360801,15160801,-639199,2010
2014-07-25,2867,A Most Wanted Man,15000000,36068890,17237855,21068890,2010
2014-07-25,5317,Happy Christmas,70000,30312,30312,-39688,2010
2014-08-07,4428,Point Blank,3000000,0,0,-3000000,2010
2014-08-08,239,Teenage Mutant Ninja Turtles,125000000,485004754,191204754,360004754,2010
2014-08-08,1054,Into the Storm,50000000,156602194,47602194,106602194,2010
2014-08-08,2239,The Hundred-Foot Journey,22000000,94270488,54235441,72270488,2010
2014-08-08,5037,The Maid's Room,600000,0,0,-600000,2010
2014-08-13,2668,Let’s Be Cops,17000000,136890774,82390774,119890774,2010
2014-08-15,357,The Expendables 3,100000000,209461378,39322544,109461378,2010
2014-08-15,2047,The Giver,25000000,55090374,45090374,30090374,2010
2014-08-15,4408,Fort McCoy,3000000,78948,78948,-2921052,2010
2014-08-15,5205,Night Lights,250000,12848,12848,-237152,2010
2014-08-18,4080,Henry & Me,5000000,0,0,-5000000,2010
2014-08-22,750,Sin City: A Dame to Kill For,65000000,39499349,13757804,-25500651,2010
2014-08-22,2651,The Prince,18000000,0,0,-18000000,2010
2014-08-22,2842,When the Game Stands Tall,15000000,30138912,30127963,15138912,2010
2014-08-22,3247,If I Stay,11000000,78356170,50474843,67356170,2010
2014-08-26,5254,Sanctuary; Quite a Conundrum,200000,0,0,-200000,2010
2014-08-27,2852,The November Man,15000000,34820335,25018119,19820335,2010
2014-08-29,2518,Dwegons and Leprechauns,20000000,0,0,-20000000,2010
2014-08-29,3985,"As Above, So Below",5000000,41824066,21222315,36824066,2010
2014-08-29,5000,Il conformista,750000,59656,59656,-690344,2010
2014-09-05,683,Legends of Oz: Dorothy’s Return,70000000,20107933,8462347,-49892067,2010
2014-09-05,2564,Neighbors,18000000,270944428,150086800,252944428,2010
2014-09-05,4019,Moms’ Night Out,5000000,10537341,10429707,5537341,2010
2014-09-05,4881,Palo Alto,1000000,1156309,767732,156309,2010
2014-09-09,4639,A Funny Thing Happened on the Way to the Forum,2000000,0,0,-2000000,2010
2014-09-09,4819,Cotton Comes to Harlem,1200000,0,0,-1200000,2010
2014-09-19,1633,The Maze Runner,34000000,348319861,102427862,314319861,2010
2014-09-19,1913,A Walk Among the Tombstones,28000000,62108587,26017685,34108587,2010
2014-09-19,2368,This is Where I Leave You,20000000,41296320,34296320,21296320,2010
2014-09-19,4391,Tusk,3000000,1821983,1821983,-1178017,2010
2014-09-19,4603,Pump,2000000,72277,72277,-1927723,2010
2014-09-19,4990,Not Cool,800000,35688,35688,-764312,2010
2014-09-26,825,The Boxtrolls,60000000,111946251,50837305,51946251,2010
2014-09-26,918,The Equalizer,55000000,192903624,101530738,137903624,2010
2014-09-26,3481,Plastic,10000000,552641,0,-9447359,2010
2014-09-26,4058,Jimi: All is By My Side,5000000,927074,340911,-4072926,2010
2014-09-26,4703,Two Night Stand,1600000,242443,15600,-1357557,2010
2014-10-01,680,The Legend of Hercules,70000000,58953319,18848538,-11046681,2010
2014-10-01,1284,Lone Survivor,40000000,149804632,125095601,109804632,2010
2014-10-01,2160,The Adventurer: The Curse of the Midas Box,25000000,0,0,-25000000,2010
2014-10-01,2206,Her,23000000,48531242,25568251,25531242,2010
2014-10-01,4953,Banshee Chapter,950000,78122,0,-871878,2010
2014-10-09,5083,Born to Fly: Elizabeth Streb vs. Gravity,500000,1822,1822,-498178,2010
2014-10-10,660,Dracula Untold,70000000,220241723,55991880,150241723,2010
2014-10-10,1055,The Judge,50000000,76119388,47119388,26119388,2010
2014-10-10,1891,"Alexander and the Terrible, Horrible, No Good, Very Bad Day",28000000,101379287,66954149,73379287,2010
2014-10-10,2945,Automata,15000000,29050,0,-14970950,2010
2014-10-10,3046,St. Vincent,13000000,54837234,44137712,41837234,2010
2014-10-10,3996,Addicted,5000000,17499242,17390770,12499242,2010
2014-10-10,4045,Kill the Messenger,5000000,6656705,2450846,1656705,2010
2014-10-10,4311,Whiplash,3300000,33474334,13092006,30174334,2010
2014-10-10,4563,Meet the Mormons,2000000,6049171,6047363,4049171,2010
2014-10-12,2068,The Gambler,25000000,38718031,33680992,13718031,2010
2014-10-17,516,Fury,80000000,210253368,85755593,130253368,2010
2014-10-17,1049,The Book of Life,50000000,97651543,50151543,47651543,2010
2014-10-17,1988,The Best of Me,26000000,41059418,26766213,15059418,2010
2014-10-17,2585,Birdman or (The Unexpected Virtue of Ignorance),18000000,103215094,42340598,85215094,2010
2014-10-17,4069,Rudderless,5000000,567219,56001,-4432781,2010
2014-10-17,4746,Housebound,1500000,236863,0,-1263137,2010
2014-10-17,4916,Camp X-Ray,1000000,9837,9837,-990163,2010
2014-10-24,1768,John Wick,30000000,76235001,43037835,46235001,2010
2014-10-24,3964,Ouija,5000000,103683342,50856010,98683342,2010
2014-10-24,4887,23 Blast,1000000,549185,549185,-450815,2010
2014-10-27,4429,Iguana,3000000,0,0,-3000000,2010
2014-10-31,2273,Before I Go to Sleep,22000000,19563579,3242457,-2436421,2010
2014-10-31,3571,Nightcrawler,8500000,50334418,32381218,41834418,2010
2014-10-31,5175,All You Need Is Love,300000,177507,0,-122493,2010
2014-11-03,4298,In the Name of the King III,3500000,0,0,-3500000,2010
2014-11-03,4678,Against the Wild,1800000,0,0,-1800000,2010
2014-11-04,220,Rio 2,130000000,493738435,131538435,363738435,2010
2014-11-04,2078,Draft Day,25000000,29276904,28842237,4276904,2010
2014-11-04,2632,The Railway Man,18000000,23910210,4438438,5910210,2010
2014-11-04,3974,Oculus,5000000,44115496,27695246,39115496,2010
2014-11-04,4214,Joe,4000000,373375,373375,-3626625,2010
2014-11-04,5212,Jesus People,250000,0,0,-250000,2010
2014-11-07,100,Dawn of the Planet of the Apes,170000000,710644566,208545589,540644566,2010
2014-11-07,4170,Boyhood,4000000,57273049,25379975,53273049,2010
2014-11-07,4245,The Perfect Wave,4000000,0,0,-4000000,2010
2014-11-07,5117,As It Is in Heaven,450000,13486,13486,-436514,2010
2014-11-11,4750,Once Upon a Time in Queens,1500000,0,0,-1500000,2010
2014-11-14,1302,Dumb and Dumber To,40000000,156553592,86208010,116553592,2010
2014-11-14,2652,Wolves,18000000,0,0,-18000000,2010
2014-11-14,2766,The Homesman,16000000,3442853,2429989,-12557147,2010
2014-11-14,3421,Rosewater,10000000,3168858,3128941,-6831142,2010
2014-11-14,3733,Beyond the Lights,7000000,14618727,14618727,7618727,2010
2014-11-14,4513,Always Woodstock,2400000,0,0,-2400000,2010
2014-11-21,232,The Hunger Games: Mockingjay - Part 1,125000000,766652288,337135885,641652288,2010
2014-11-21,4831,The Sleepwalker,1100000,2636,2636,-1097364,2010
2014-11-21,4958,Food Chains,913000,0,0,-913000,2010
2014-11-26,210,Penguins of Madagascar,132000000,367650911,83350911,235650911,2010
2014-11-26,1331,Horrible Bosses 2,40000000,105945357,54445357,65945357,2010
2014-11-28,2800,The Imitation Game,15000000,227773686,91125143,212773686,2010
2014-11-28,4894,Antarctica: A Year on Ice,1000000,288757,288757,-711243,2010
2014-12-02,265,RoboCop,120000000,242981799,58607007,122981799,2010
2014-12-08,3668,Swelter,8000000,0,0,-8000000,2010
2014-12-08,4955,Jesse,950000,0,0,-950000,2010
2014-12-09,1496,Dolphin Tale 2,36000000,57824533,42024533,21824533,2010
2014-12-09,3030,No Good Deed,13200000,54323210,52543632,41123210,2010
2014-12-09,3095,The Drop,12600000,19054534,10724389,6454534,2010
2014-12-09,4052,Atlas Shrugged: Who Is John Galt?,5000000,851690,851690,-4148310,2010
2014-12-09,4862,The Skeleton Twins,1000000,5797192,5284309,4797192,2010
2014-12-09,5046,Faith Connections,550000,9111,9111,-540889,2010
2014-12-09,5253,Archaeology of a Woman,200000,0,0,-200000,2010
2014-12-12,190,Exodus: Gods and Kings,140000000,268314513,65014513,128314513,2010
2014-12-12,2462,Inherent Vice,20000000,8692898,8110975,-11307102,2010
2014-12-12,3157,Top Five,12000000,25514848,25317379,13514848,2010
2014-12-17,16,The Hobbit: The Battle of the Five Armies,250000000,955119788,255119788,705119788,2010
2014-12-19,230,Night at the Museum: Secret of the Tomb,127000000,356546621,113746621,229546621,2010
2014-12-19,723,Annie,65000000,139840525,85911262,74840525,2010
2014-12-19,3004,Mr. Turner,14000000,25187026,3958546,11187026,2010
2014-12-25,716,Unbroken,65000000,163527824,115637895,98527824,2010
2014-12-25,882,American Sniper,58000000,547326372,350126372,489326372,2010
2014-12-25,1010,Into the Woods,50000000,203502372,128002372,153502372,2010
2014-12-25,3378,Big Eyes,10000000,27317872,14482031,17317872,2010
2014-12-26,3475,Barbecue,10000000,173613,388,-9826387,2010
2014-12-31,1434,Dragon Nest Warriors' Dawn,40000000,196090,0,-39803910,2010
2014-12-31,2474,A Most Violent Year,20000000,6071433,5749134,-13928567,2010
2014-12-31,4415,Demonic,3000000,4668109,0,1668109,2010
2014-12-31,4637,Lucky Dog,2000000,0,0,-2000000,2010
2014-12-31,4762,Kurmanjan datka,1400000,0,0,-1400000,2010
2014-12-31,4764,House at the End of the Drive,1400000,0,0,-1400000,2010
2014-12-31,4941,Doc Holliday's Revenge,1000000,0,0,-1000000,2010
2014-12-31,4945,Bang Bang Baby,1000000,0,0,-1000000,2010
2014-12-31,4967,40 Weeks,900000,0,0,-900000,2010
2014-12-31,5005,Destiny,750000,450,0,-749550,2010
2014-12-31,5022,The Hadza: Last of the First,650000,0,0,-650000,2010
2014-12-31,5038,Light from the Darkroom,600000,0,0,-600000,2010
2014-12-31,5092,America Is Still The Place,500000,0,0,-500000,2010
2014-12-31,5096,Diamond Rufff,500000,0,0,-500000,2010
2014-12-31,5099,Fight to the Finish,500000,0,0,-500000,2010
2014-12-31,5106,The Sound and the Shadow,500000,0,0,-500000,2010
2014-12-31,5119,Rise Of the Entrepreneur - The Search For A Better Way,450000,0,0,-450000,2010
2014-12-31,5138,Pancakes,400000,0,0,-400000,2010
2014-12-31,5215,Horse Camp,250000,0,0,-250000,2010
2014-12-31,5257,H.,200000,0,0,-200000,2010
2014-12-31,5307,"Dude, Where's My Dog",100000,0,0,-100000,2010
2014-12-31,5338,The Image Revolution,50000,0,0,-50000,2010
2014-12-31,5347,Happy 40th,35000,0,0,-35000,2010
2014-12-31,5364,Dry Spell,22000,0,0,-22000,2010
2014-12-31,5371,Stories of Our Lives,15000,0,0,-15000,2010
2015-01-04,3255,Woman in Gold,11000000,56758138,33307793,45758138,2010
2015-01-05,10,Avengers: Age of Ultron,250000000,1404705868,459005868,1154705868,2010
2015-01-07,129,Terminator: Genisys,155000000,440160956,89760956,285160956,2010
2015-01-07,2952,Magic Mike XXL,14500000,123709460,66013057,109209460,2010
2015-01-09,2947,Broken Horses,15000000,3471,0,-14996529,2010
2015-01-09,3787,Alpha & Omega: The Legend of the Saw Tooth Cave,7000000,0,0,-7000000,2010
2015-01-09,4302,Lords of London,3440000,0,0,-3440000,2010
2015-01-09,5337,"Run, Hide, Die",50000,0,0,-50000,2010
2015-01-09,5359,Backmask,25000,428923,0,403923,2010
2015-01-12,1857,Grace of Monaco,30000000,25199891,0,-4800109,2010
2015-01-12,4646,Shark Lake,2000000,0,0,-2000000,2010
2015-01-12,5104,Brooklyn Bizarre,500000,0,0,-500000,2010
2015-01-12,5362,Dutch Kills,25000,0,0,-25000,2010
2015-01-13,4084,Capricorn One,5000000,0,0,-5000000,2010
2015-01-13,4790,Da Sweet Blood of Jesus,1250000,0,0,-1250000,2010
2015-01-16,684,Blackhat,70000000,19548419,7889395,-50451581,2010
2015-01-16,926,Paddington,55000000,259541430,76223578,204541430,2010
2015-01-16,2200,The Wedding Ringer,23000000,80171596,64460211,57171596,2010
2015-01-16,3993,Still Alice,5000000,41699612,18656400,36699612,2010
2015-01-20,3558,Veronika Decides to Die,9000000,2243,0,-8997757,2010
2015-01-20,4316,The Opposite Sex,3300000,40262,0,-3259738,2010
2015-01-23,875,Mortdecai,60000000,30396134,7696134,-29603866,2010
2015-01-23,3895,Song One,6000000,32544,32251,-5967456,2010
2015-01-23,3938,R100,5500000,24956,24956,-5475044,2010
2015-01-23,4091,Mommy,4900000,17561100,3498695,12661100,2010
2015-01-23,4167,The Boy Next Door,4000000,52819253,35423380,48819253,2010
2015-01-27,4081,Born of War,5000000,0,0,-5000000,2010
2015-01-30,1853,Wild Card,30000000,929157,3200,-29070843,2010
2015-01-30,3161,Project Almanac,12000000,32248241,22348241,20248241,2010
2015-01-30,3521,Black or White,9000000,21571189,21571189,12571189,2010
2015-01-30,3776,Trudno byt bogom,7000000,35919,31443,-6964081,2010
2015-01-30,4221,"Guten Tag, Ramon",4000000,4854356,154356,854356,2010
2015-01-30,4774,Above and Beyond,1300000,288751,288751,-1011249,2010
2015-02-10,311,The Martian,108000000,663851905,228433663,555851905,2010
2015-02-10,1118,Shanghai,50000000,15505922,46425,-34494078,2010
2015-02-10,3767,Freeheld,7000000,1732228,546201,-5267772,2010
2015-02-13,386,Kingsman: The Secret Service,94000000,404561724,128261724,310561724,2010
2015-02-13,1279,Fifty Shades of Grey,40000000,570998101,166167230,530998101,2010
2015-02-13,4597,The Last Five Years,2000000,147299,147299,-1852701,2010
2015-02-13,4751,Girlhouse,1500000,0,0,-1500000,2010
2015-02-13,4912,Hits,1000000,15156,15156,-984844,2010
2015-02-20,2679,"McFarland, USA",17000000,45707924,44480275,28707924,2010
2015-02-20,2993,Hot Tub Time Machine 2,14000000,12452601,12314651,-1547399,2010
2015-02-20,3570,The DUFF,8500000,43528634,34030343,35028634,2010
2015-02-24,3669,Green Street Hooligans: Underground,8000000,0,0,-8000000,2010
2015-02-24,3697,Outside Bet,7500000,13524,0,-7486476,2010
2015-02-24,5039,Irreplaceable,600000,0,0,-600000,2010
2015-02-24,5216,Give Me Shelter,250000,0,0,-250000,2010
2015-02-27,733,Focus,65000000,154362963,53862963,89362963,2010
2015-02-27,3978,The Lazarus Effect,5000000,35341814,25801570,30341814,2010
2015-02-27,4229,Praia do Futuro,4000000,760678,20620,-3239322,2010
2015-02-27,5260,Butterfly Girl,180000,17503,17503,-162497,2010
2015-03-02,4820,Bleeding Hearts,1200000,0,0,-1200000,2010
2015-03-02,5214,UnDivided,250000,0,0,-250000,2010
2015-03-03,4309,To Write Love On Her Arms,3400000,0,0,-3400000,2010
2015-03-03,4956,Ask Me Anything,950000,0,0,-950000,2010
2015-03-04,59,Furious 7,190000000,1516748684,351032910,1326748684,2010
2015-03-06,1790,Entourage,30000000,46225326,32363404,16225326,2010
2015-03-07,4503,Stung,2500000,0,0,-2500000,2010
2015-03-13,370,Cinderella,95000000,534551353,201151353,439551353,2010
2015-03-13,1085,Run All Night,50000000,66961644,26461644,16961644,2010
2015-03-13,1630,The Lovers,35000000,11106,0,-34988894,2010
2015-03-13,3471,Hross i oss,10000000,11894,11894,-9988106,2010
2015-03-13,4549,It Follows,2000000,20649774,14674077,18649774,2010
2015-03-13,5016,Walter,700000,0,0,-700000,2010
2015-03-17,2001,Accidental Love,26000000,135436,0,-25864564,2010
2015-03-17,4427,Something Wicked,3000000,0,0,-3000000,2010
2015-03-17,4631,The Lady from Shanghai,2000000,0,0,-2000000,2010
2015-03-17,5309,Closure,100000,0,0,-100000,2010
2015-03-20,288,The Divergent Series: Insurgent,110000000,295279072,130179072,185279072,2010
2015-03-20,1409,The Gunman,40000000,13644292,10664749,-26355708,2010
2015-03-20,3410,Danny Collins,10000000,7501132,5637066,-2498868,2010
2015-03-20,4516,Do You Believe?,2300000,14305540,12985600,12005540,2010
2015-03-20,4641,The Walking Deceased,2000000,0,0,-2000000,2010
2015-03-24,5206,Along the Roadside,250000,3234,0,-246766,2010
2015-03-25,5311,Open Secret,100000,0,0,-100000,2010
2015-03-27,216,Home,130000000,386069390,177397510,256069390,2010
2015-03-27,1298,Get Hard,40000000,106511453,90411453,66511453,2010
2015-03-27,3396,While We're Young,10000000,13423176,7582065,3423176,2010
2015-03-31,5139,Viskningar och rop,400000,0,0,-400000,2010
2015-04-08,5336,Bending Steel,50000,0,0,-50000,2010
2015-04-09,754,Tian jiang xiong shi,65000000,122519874,74070,57519874,2010
2015-04-09,2260,The Transporter Refueled,22000000,69698495,16029670,47698495,2010
2015-04-09,4411,Before We Go,3000000,379161,37151,-2620839,2010
2015-04-09,5264,Heroes of Dirt,175000,0,0,-175000,2010
2015-04-11,3252,Brooklyn,11000000,62076141,38322743,51076141,2010
2015-04-12,2821,Krampus,15000000,61788393,42725475,46788393,2010
2015-04-14,3676,Loin des hommes,7700000,1080428,5336,-6619572,2010
2015-04-14,5095,Roadside,500000,0,0,-500000,2010
2015-04-15,4521,The Toxic Avenger Part II,2300000,0,0,-2300000,2010
2015-04-17,1115,Child 44,50000000,3434330,1224330,-46565670,2010
2015-04-17,1450,Paul Blart: Mall Cop 2,38000000,107597242,71038190,69597242,2010
2015-04-17,4752,Closer to the Moon,1500000,0,0,-1500000,2010
2015-04-17,4843,Unfriended,1000000,62561449,32482090,61561449,2010
2015-04-17,5274,Antarctic Edge: 70º South,150000,7193,7193,-142807,2010
2015-04-21,4648,The Marine 4,1950000,0,0,-1950000,2010
2015-04-21,5361,Ten,25000,0,0,-25000,2010
2015-04-21,5367,The Front Man,20000,0,0,-20000,2010
2015-04-24,1770,The Age of Adaline,30000000,69057415,42629776,39057415,2010
2015-04-24,2002,The Face of an Angel,26000000,0,0,-26000000,2010
2015-04-24,2153,Yi ge ren de wu lin,25000000,129115,129115,-24870885,2010
2015-04-24,2230,The Water Diviner,22500000,30864649,4200117,8364649,2010
2015-04-24,2471,Little Boy,20000000,17684355,6485961,-2315645,2010
2015-04-24,4653,Brotherly Love,1900000,478595,478595,-1421405,2010
2015-05-05,2941,A Few Best Men,15000000,17224539,0,2224539,2010
2015-05-05,3939,Miss Julie,5500000,863895,0,-4636105,2010
2015-05-05,4968,Le bonheur d'Elza,900000,0,0,-900000,2010
2015-05-06,717,Spy!,65000000,233125712,110825712,168125712,2010
2015-05-06,1854,United Passions,30000000,168832,918,-29831168,2010
2015-05-06,2955,Freedom,14500000,565801,0,-13934199,2010
2015-05-06,3315,Insidious Chapter 3,10000000,120678444,52218558,110678444,2010
2015-05-06,4300,Dawn Patrol,3500000,0,0,-3500000,2010
2015-05-08,2092,Shaun the Sheep,25000000,101937062,19375982,76937062,2010
2015-05-15,153,Mad Max: Fury Road,150000000,370742166,153636354,220742166,2010
2015-05-15,1864,Pitch Perfect 2,29000000,287130801,183785415,258130801,2010
2015-05-15,3698,Pound of Flesh,7500000,0,0,-7500000,2010
2015-05-15,4072,Area 51,5000000,7556,7556,-4992444,2010
2015-05-15,4921,Childless,1000000,1036,1036,-998964,2010
2015-05-19,3489,Into the Grizzly Maze,10000000,0,0,-10000000,2010
2015-05-19,5381,Family Motocross,10000,0,0,-10000,2010
2015-05-22,105,Tomorrowland,170000000,207283457,93436322,37283457,2010
2015-05-22,1544,Poltergeist,35000000,95825125,47425125,60825125,2010
2015-05-22,3661,Aloft,8000000,53086,53086,-7946914,2010
2015-05-22,5034,Drunk Wedding,600000,3301,3301,-596699,2010
2015-05-26,4753,Mutant World,1500000,0,0,-1500000,2010
2015-05-29,285,San Andreas,110000000,469590832,155190832,359590832,2010
2015-05-29,1488,Aloha,37000000,24935799,21052030,-12064201,2010
2015-05-29,2514,Survivor,20000000,774905,0,-19225095,2010
2015-06-02,80,Jupiter Ascending,179000000,181982519,47482519,2982519,2010
2015-06-02,381,Seventh Son,95000000,110623265,17223265,15623265,2010
2015-06-02,616,The SpongeBob Movie: Sponge Out of Water,74000000,311594032,162994032,237594032,2010
2015-06-02,4426,Enter the Dangerous Mind,3000000,0,0,-3000000,2010
2015-06-03,1121,Chappie,49000000,105002056,31569268,56002056,2010
2015-06-03,1608,Unfinished Business,35000000,12819501,10219501,-22180499,2010
2015-06-03,3332,The Second Best Exotic Marigold Hotel,10000000,90384306,33078266,80384306,2010
2015-06-03,4741,Road Hard,1500000,113169,113169,-1386831,2010
2015-06-10,4540,The Timber,2100000,0,0,-2100000,2010
2015-06-11,4,Spectre,300000000,879620923,200074175,579620923,2010
2015-06-11,367,The Peanuts Movie,99000000,250474038,130178411,151474038,2010
2015-06-11,2347,Spotlight,20000000,92217729,45055776,72217729,2010
2015-06-19,84,Inside Out,175000000,853707581,356461711,678707581,2010
2015-06-19,3729,Dope,7000000,18190831,17506470,11190831,2010
2015-06-19,4223,Manglehorn,4000000,797439,132270,-3202561,2010
2015-06-19,5236,The Overnight,200000,1165996,1109808,965996,2010
2015-06-23,5102,Crossroads,500000,0,0,-500000,2010
2015-06-26,691,Ted 2,68000000,217022588,81284830,149022588,2010
2015-06-26,2348,Max,20000000,43658157,42656255,23658157,2010
2015-06-26,2711,Escobar: Paradise Lost,17000000,1973945,195792,-15026055,2010
2015-06-26,4782,The Algerian,1300000,0,0,-1300000,2010
2015-06-30,2000,Viy,26000000,34246770,0,8246770,2010
2015-07-04,4606,Lost River,2000000,45431,45431,-1954569,2010
2015-07-04,4835,Silent Running,1100000,0,0,-1100000,2010
2015-07-07,5313,Tiger Orange,100000,0,0,-100000,2010
2015-07-08,267,Fantastic Four,120000000,167117548,56117548,47117548,2010
2015-07-08,2594,Ricki and the Flash,18000000,41148679,26822144,23148679,2010
2015-07-08,3967,The Gift,5000000,58978653,43787265,53978653,2010
2015-07-08,4583,The Diary of a Teenage Girl,2000000,2279959,1477002,279959,2010
2015-07-17,215,Ant-Man,130000000,518602163,180202163,388602163,2010
2015-07-17,1519,Trainwreck,35000000,140949327,110038130,105949327,2010
2015-07-17,5315,Dawn of the Crescent Moon,75000,8799,8799,-66201,2010
2015-07-21,3490,American Heist,10000000,0,0,-10000000,2010
2015-07-24,414,Pixels,90000000,244126300,78747585,154126300,2010
2015-07-24,1757,Southpaw,30000000,94207861,52421953,64207861,2010
2015-07-24,3083,The Vatican Tapes,13000000,14999638,1784763,1999638,2010
2015-07-24,3145,Paper Towns,12000000,85512300,32000304,73512300,2010
2015-07-24,5093,The Outrageous Sophie Tucker,500000,0,0,-500000,2010
2015-07-29,1698,Vacation,31000000,100655892,58884188,69655892,2010
2015-07-31,147,Mission: Impossible—Rogue Nation,150000000,700868363,195042377,550868363,2010
2015-07-31,1655,The Young and Prodigious T.S. Spivet,33000000,357687,176847,-32642313,2010
2015-07-31,4903,Beyond the Brick: A LEGO Brickumentary,1000000,101531,101531,-898469,2010
2015-07-31,5333,Counting,50000,8374,8374,-41626,2010
2015-08-05,1558,Hot Pursuit,35000000,45680201,34580201,10680201,2010
2015-08-05,3283,La famille Bélier,11000000,74056184,0,63056184,2010
2015-08-05,3556,Skin Trade,9000000,1242,1242,-8998758,2010
2015-08-05,4134,Maggie,4500000,597989,187112,-3902011,2010
2015-08-09,4247,Chain of Command,4000000,0,0,-4000000,2010
2015-08-09,4755,Checkmate,1500000,0,0,-1500000,2010
2015-08-12,5182,Amidst the Devil's Wings,300000,0,0,-300000,2010
2015-08-14,599,The Man From U.N.C.L.E.,75000000,105445109,45445109,30445109,2010
2015-08-14,1883,Straight Outta Compton,28000000,202043881,161058685,174043881,2010
2015-08-14,3088,Brothers,13000000,17856688,656688,4856688,2010
2015-08-14,4431,Amnesiac,3000000,0,0,-3000000,2010
2015-08-18,3780,Z Storm,7000000,2053330,0,-4946670,2010
2015-08-18,5219,The Love Letter,250000,0,0,-250000,2010
2015-08-21,1584,Hitman: Agent 47,35000000,81967450,22467450,46967450,2010
2015-08-21,1918,American Ultra,28000000,28208085,14439985,208085,2010
2015-08-21,3347,Sinister 2,10000000,54104225,27740955,44104225,2010
2015-08-21,4643,The Curse of Downers Grove,2000000,0,0,-2000000,2010
2015-08-21,5275,Top Spin,150000,5858,5858,-144142,2010
2015-08-26,3976,No Escape,5000000,42844516,27288872,37844516,2010
2015-08-28,4144,Zipper,4500000,0,0,-4500000,2010
2015-08-28,4332,War Room,3000000,73975239,67790117,70975239,2010
2015-08-28,4572,We Are Your Friends,2000000,10166209,3591417,8166209,2010
2015-08-28,4807,Que Horas Ela Volta?,1200000,3048209,376976,1848209,2010
2015-08-28,4973,Windsor Drive,850000,3256,3256,-846744,2010
2015-09-01,1128,Taken 3,48000000,327656424,89256424,279656424,2010
2015-09-01,2339,Selma,20000000,66776908,52076908,46776908,2010
2015-09-01,3696,Black November,7500000,32572,0,-7467428,2010
2015-09-01,4083,Let's Kill Ward's Wife,5000000,0,0,-5000000,2010
2015-09-01,4992,Vessel,800000,0,0,-800000,2010
2015-09-10,169,Pan,150000000,123888320,35088320,-26111680,2010
2015-09-10,1816,Steve Jobs,30000000,35579007,17766658,5579007,2010
2015-09-10,3221,Trash,12000000,6553186,17484,-5446814,2010
2015-09-10,5220,Western Religion,250000,0,0,-250000,2010
2015-09-18,737,Everest,65000000,221662676,43309450,156662676,2010
2015-09-18,770,Maze Runner: The Scorch Trials,61000000,310697192,81697192,249697192,2010
2015-09-18,979,Black Mass,53000000,98837872,62575678,45837872,2010
2015-09-18,1764,Sicario,30000000,78571737,46889293,48571737,2010
2015-09-18,4575,Captive,2000000,2791973,2583301,791973,2010
2015-09-18,4812,La navaja de Don Juan,1200000,4254,4254,-1195746,2010
2015-09-25,490,Hotel Transylvania 2,80000000,470751398,169700110,390751398,2010
2015-09-25,1307,The Intern,40000000,197232734,75764672,157232734,2010
2015-09-25,4088,Navy SEAL vs. Zombies,5000000,0,0,-5000000,2010
2015-09-25,4858,The Green Inferno,1000000,12931569,7192291,11931569,2010
2015-09-28,4745,"Me, You and Five Bucks",1500000,2105,2105,-1497895,2010
2015-09-29,4148,R.L. Stine's Monsterville: The Cabinet of Souls,4400000,0,0,-4400000,2010
2015-09-29,5255,Theresa Is a Mother,200000,0,0,-200000,2010
2015-09-29,5316,Queen Crab,75000,0,0,-75000,2010
2015-09-29,5389,Signed Sealed Delivered,5000,0,0,-5000,2010
2015-09-29,5390,A Plague So Pleasant,1400,0,0,-1400,2010
2015-09-30,1610,The Walk,35000000,61173364,10137502,26173364,2010
2015-10-02,4943,Fear Clinic,1000000,0,0,-1000000,2010
2015-10-02,5097,Love in the Time of Monsters,500000,0,0,-500000,2010
2015-10-03,2158,Red Sky,25000000,91116,0,-24908884,2010
2015-10-03,3482,Jungle Shuffle,10000000,314073,0,-9685927,2010
2015-10-03,4105,Treading Water,4700000,0,0,-4700000,2010
2015-10-03,4944,The Pet,1000000,0,0,-1000000,2010
2015-10-03,5094,Subconscious,500000,0,0,-500000,2010
2015-10-03,5179,Teeth and Blood,300000,0,0,-300000,2010
2015-10-04,1635,The Longest Ride,34000000,63802928,37446117,29802928,2010
2015-10-04,3057,Ex Machina,13000000,38976797,25440971,25976797,2010
2015-10-04,4220,Desert Dancer,4000000,324218,155271,-3675782,2010
2015-10-04,4918,The Sisterhood of Night,1000000,6870,6870,-993130,2010
2015-10-07,615,Minions,74000000,1167245366,336045770,1093245366,2010
2015-10-07,1415,Baahubali: The Beginning,40000000,26736665,6738000,-13263335,2010
2015-10-07,1994,Self/Less,26000000,33713827,12279691,7713827,2010
2015-10-07,3470,Strangerland,10000000,161097,17472,-9838903,2010
2015-10-07,5295,The Gallows,100000,41753881,22764410,41653881,2010
2015-10-11,5108,The Little Ponderosa Zoo,500000,0,0,-500000,2010
2015-10-11,5256,Perfect Cowboy,200000,0,0,-200000,2010
2015-10-11,5312,The Night Visitor,100000,0,0,-100000,2010
2015-10-13,4505,8 Days,2500000,0,0,-2500000,2010
2015-10-16,883,Goosebumps,58000000,158905324,80069458,100905324,2010
2015-10-16,953,Crimson Peak,55000000,75466595,31090320,20466595,2010
2015-10-16,1311,Bridge of Spies,40000000,162610473,72313754,122610473,2010
2015-10-16,2926,Nie yin niang,15000000,6832542,632542,-8167458,2010
2015-10-16,3065,Room,13000000,36262783,14677674,23262783,2010
2015-10-20,4679,Beginners Guide to Sex,1800000,0,0,-1800000,2010
2015-10-20,5151,Rotor DR1,350000,0,0,-350000,2010
2015-10-23,542,The Last Witch Hunter,80000000,131234406,27367660,51234406,2010
2015-10-23,3002,Suffragette,14000000,34044909,4702420,20044909,2010
2015-10-23,3362,Paranormal Activity: The Ghost Dimension,10000000,78096553,18297124,68096553,2010
2015-10-23,4047,Jem and the Holograms,5000000,2368937,2184640,-2631063,2010
2015-10-23,4622,Bone Tomahawk,2000000,481525,0,-1518475,2010
2015-10-23,5174,The Looking Glass,300000,1711,1711,-298289,2010
2015-10-27,4090,Running Forever,5000000,0,0,-5000000,2010
2015-10-27,4947,The Horror Network,1000000,0,0,-1000000,2010
2015-10-30,1656,Freaks of Nature,33000000,0,0,-33000000,2010
2015-10-30,1924,Our Brand is Crisis,28000000,8592432,7002261,-19407568,2010
2015-10-30,2434,Burnt,20000000,32632668,13651946,12632668,2010
2015-10-30,2509,Regression,20000000,14883495,55039,-5116505,2010
2015-10-30,2914,Scout's Guide to the Zombie Apocalypse,15000000,14947243,3703046,-52757,2010
2015-10-30,3230,Dancin' It's On,12000000,0,0,-12000000,2010
2015-11-08,5103,Alleluia! The Devil's Carnival,500000,0,0,-500000,2010
2015-11-08,5285,The Brain That Sings,125000,0,0,-125000,2010
2015-11-09,2578,The Perfect Guy,18000000,60264805,57017904,42264805,2010
2015-11-09,3961,The Visit,5000000,98595211,65112020,93595211,2010
2015-11-09,4036,90 Minutes in Heaven,5000000,4816142,4816142,-183858,2010
2015-11-11,3223,10 Days in a Madhouse,12000000,14616,14616,-11985384,2010
2015-11-12,361,In the Heart of the Sea,100000000,90420758,25020758,-9579242,2010
2015-11-12,880,The Ridiculous 6,60000000,0,0,-60000000,2010
2015-11-12,1888,The Big Short,28000000,133162752,70259870,105162752,2010
2015-11-12,4433,Close Range,3000000,0,0,-3000000,2010
2015-11-12,4927,American Hero,1000000,26,0,-999974,2010
2015-11-13,2116,The 33,25000000,28400715,12227722,3400715,2010
2015-11-13,2489,My All-American,20000000,2246000,2246000,-17754000,2010
2015-11-13,2500,By the Sea,20000000,3727746,538460,-16272254,2010
2015-11-13,2597,Love the Coopers,18000000,42167286,26302731,24167286,2010
2015-11-13,3562,Heist,8900000,3324184,50136,-5575816,2010
2015-11-20,118,The Hunger Games: Mockingjay - Part 2,160000000,650523427,281723902,490523427,2010
2015-11-20,2051,The Night Before,25000000,52427346,43035725,27427346,2010
2015-11-20,2143,Legend,25000000,42642077,1872994,17642077,2010
2015-11-20,2404,Secret in Their Eyes,20000000,30808558,20180155,10808558,2010
2015-11-20,3783,Criminal Activities,7000000,103962,0,-6896038,2010
2015-11-20,4754,#Horror,1500000,0,0,-1500000,2010
2015-11-20,5115,Siakh lokhamim: ha'slilim ha'gnouzim,450000,42503,41260,-407497,2010
2015-11-25,65,The Good Dinosaur,187500000,334342692,123087120,146842692,2010
2015-11-25,1417,Victor Frankenstein,40000000,33175076,5775076,-6824924,2010
2015-11-25,1478,Creed,37000000,173567581,109767581,136567581,2010
2015-12-06,28,Jurassic World,215000000,1671640593,652198010,1456640593,2010
2015-12-06,3632,Me and Earl and the Dying Girl,8000000,9266180,6758416,1266180,2010
2015-12-18,2,Star Wars Ep. VII: The Force Awakens,306000000,2058662225,936662225,1752662225,2010
2015-12-18,411,Alvin and the Chipmunks: The Road Chip,90000000,249520430,85886987,159520430,2010
2015-12-18,1724,Sisters,30000000,106030660,87044645,76030660,2010
2015-12-22,4949,Por amor en el caserio,1000000,0,0,-1000000,2010
2015-12-22,5327,The Brain That Wouldn't Die,60000,0,0,-60000,2010
2015-12-25,360,Point Break,100000000,128131571,28782481,28131571,2010
2015-12-25,765,The Hateful Eight,62000000,145443360,54117416,83443360,2010
2015-12-25,819,Joy,60000000,101134059,56451232,41134059,2010
2015-12-25,1007,Daddy’s Home,50000000,238757137,150357137,188757137,2010
2015-12-25,1559,Concussion,35000000,50363790,34531832,15363790,2010
2015-12-30,3638,Anomalisa,8000000,5531455,3759286,-2468545,2010
2015-12-31,556,"Don Gato, el inicio de la pandilla",80000000,4547660,0,-75452340,2010
2015-12-31,1271,Pourquoi j'ai pas mangé mon père,42000000,182156,0,-41817844,2010
2015-12-31,1435,The Crow,40000000,0,0,-40000000,2010
2015-12-31,1861,Bilal,30000000,141661,0,-29858339,2010
2015-12-31,2942,Chiamatemi Francesco - Il papa della gente,15000000,3454036,0,-11545964,2010
2015-12-31,3231,San cheng ji,12000000,0,0,-12000000,2010
2015-12-31,3671,Henry Joseph Church,8000000,0,0,-8000000,2010
2015-12-31,3781,ГЕРОЙ,7000000,1391410,0,-5608590,2010
2015-12-31,4087,Aztec Warrior,5000000,0,0,-5000000,2010
2015-12-31,4244,The Veil,4000000,0,0,-4000000,2010
2015-12-31,4424,AWOL-72,3000000,0,0,-3000000,2010
2015-12-31,4432,Unnatural,3000000,0,0,-3000000,2010
2015-12-31,4452,Sardaar Ji,2700000,8200000,0,5500000,2010
2015-12-31,4625,"To Be Frank, Sinatra at 100",2000000,926,0,-1999074,2010
2015-12-31,4644,Wind Walkers,2000000,0,0,-2000000,2010
2015-12-31,4659,Vaalu,1900000,12444,0,-1887556,2010
2015-12-31,4763,One Shot,1400000,0,0,-1400000,2010
2015-12-31,4925,Karachi se Lahore,1000000,17721,0,-982279,2010
2015-12-31,5042,Julija in alfa Romeo,560000,8462,0,-551538,2010
2015-12-31,5107,Rodeo Girl,500000,0,0,-500000,2010
2015-12-31,5180,Walking to Paris,300000,0,0,-300000,2010
2015-12-31,5218,Shooting the Warwicks,250000,0,0,-250000,2010
2015-12-31,5221,4-Nov,250000,0,0,-250000,2010
2015-12-31,5267,Lumea e a mea,168000,29827,0,-138173,2010
2015-12-31,5279,Escaping the Holocost,150000,0,0,-150000,2010
2015-12-31,5286,Romantic Schemer,125000,0,0,-125000,2010
2015-12-31,5310,Lunchtime Heroes,100000,0,0,-100000,2010
2016-01-03,4946,1982,1000000,0,0,-1000000,2010
2016-01-04,3986,God’s Not Dead 2,5000000,23565072,20773069,18565072,2010
2016-01-04,4961,Meet the Blacks,900000,9097072,9097072,8197072,2010
2016-01-07,77,The Legend of Tarzan,180000000,349143061,126643061,169143061,2010
2016-01-07,191,The BFG,140000000,154110769,55483770,14110769,2010
2016-01-07,3308,The Purge: Election Year,10000000,118557124,79042440,108557124,2010
2016-01-11,3014,Reign of Assassins,14000000,11354230,0,-2645770,2010
2016-01-15,1045,13 Hours: The Secret Soldiers of Benghazi,50000000,69411370,52853219,19411370,2010
2016-01-15,1296,Ride Along 2,40000000,124827316,90862685,84827316,2010
2016-01-15,2608,Norm of the North,18000000,27392196,17062499,9392196,2010
2016-01-19,4522,Eden,2300000,0,0,-2300000,2010
2016-01-19,4541,Sharkskin,2100000,0,0,-2100000,2010
2016-01-22,905,Zhuo yao ji,56000000,386096060,32766,330096060,2010
2016-01-22,1459,The 5th Wave,38000000,110678636,34912982,72678636,2010
2016-01-22,1504,Yip Man 3,36000000,156835197,2679437,120835197,2010
2016-01-22,3236,Dirty Grandpa,11500000,99930262,35593113,88430262,2010
2016-01-22,3327,The Boy,10000000,68220952,35819556,58220952,2010
2016-01-29,185,Kung Fu Panda 3,140000000,518614384,143528619,378614384,2010
2016-01-29,674,The Finest Hours,70000000,48197252,27569558,-21802748,2010
2016-01-29,2145,Jane Got a Gun,25000000,2976636,1513793,-22023364,2010
2016-01-29,4014,Fifty Shades of Black,5000000,20765353,11686940,15765353,2010
2016-02-02,4507,The Rise of the Krays,2500000,0,0,-2500000,2010
2016-02-09,2441,The Light Between Oceans,20000000,19450780,12545979,-549220,2010
2016-02-09,3637,Morgan,8000000,7315248,3915251,-684752,2010
2016-02-09,4076,Yoga Hosers,5000000,2199,0,-4997801,2010
2016-02-09,4506,Antibirth,2500000,0,0,-2500000,2010
2016-02-12,3528,Jackie,9000000,25077411,13960394,16077411,2010
2016-02-19,772,Mei Ren Yu,60720000,552198479,3229457,491478479,2010
2016-02-19,2359,Risen,20000000,46164361,36880033,26164361,2010
2016-02-19,2653,Forsaken,18000000,0,0,-18000000,2010
2016-02-19,3991,Race,5000000,22178125,19115191,17178125,2010
2016-02-19,4269,The Witch,3500000,40454520,25138705,36954520,2010
2016-02-26,192,Gods of Egypt,140000000,133553464,31153464,-6446536,2010
2016-02-26,2212,Eddie the Eagle,23000000,45121177,15789389,22121177,2010
2016-02-26,2440,Triple 9,20000000,25943792,12639297,5943792,2010
2016-03-06,206,Teenage Mutant Ninja Turtles: Out of the Shadows,135000000,245623848,82051601,110623848,2010
2016-03-06,2336,Me Before You,20000000,205445075,56245075,185445075,2010
2016-03-06,2454,Popstar: Never Stop Never Stopping,20000000,9537120,9496130,-10462880,2010
2016-03-06,4291,Time to Choose,3500000,29233,29233,-3470767,2010
2016-03-06,5265,The Fits,170000,169242,166425,-758,2010
2016-03-15,4089,The Hatching,5000000,0,0,-5000000,2010
2016-03-16,3035,Miracles from Heaven,13000000,73798720,61705123,60798720,2010
2016-03-18,300,The Divergent Series: Allegiant,110000000,171484051,66184051,61484051,2010
2016-03-18,2634,Midnight Special,18000000,6841142,3712282,-11158858,2010
2016-03-25,12,Batman v Superman: Dawn of Justice,250000000,868160194,330360194,618160194,2010
2016-03-25,2577,My Big Fat Greek Wedding 2,18000000,91651878,59689605,73651878,2010
2016-03-30,3416,Everybody Wants Some,10000000,5437126,3400278,-4562874,2010
2016-04-03,136,Zootopia,150000000,1019922983,341268248,869922983,2010
2016-04-03,811,London Has Fallen,60000000,193857962,62524260,133857962,2010
2016-04-03,1582,Whiskey Tango Foxtrot,35000000,24915969,23083334,-10084031,2010
2016-04-03,5035,They Will Have to Kill Us First,600000,7943,0,-592057,2010
2016-04-11,108,Doctor Strange,165000000,677541920,232641920,512541920,2010
2016-04-11,244,Trolls,125000000,344780046,153707064,219780046,2010
2016-04-11,1317,Hacksaw Ridge,40000000,158701644,67209615,118701644,2010
2016-04-15,83,The Jungle Book,175000000,963901123,364001123,788901123,2010
2016-04-15,1692,Criminal,31500000,38771262,14708696,7271262,2010
2016-04-15,2337,Barbershop: The Next Cut,20000000,54404202,54030051,34404202,2010
2016-04-15,2649,I Am Wrath,18000000,6784,0,-17993216,2010
2016-04-15,4042,Green Room,5000000,3807503,3220371,-1192497,2010
2016-04-22,278,The Huntsman: Winter’s War,115000000,165149302,48003015,50149302,2010
2016-04-22,4384,Compadres,3000000,7445044,3127773,4445044,2010
2016-04-22,4728,Unsullied,1500000,510957,510957,-989043,2010
2016-04-29,2458,Ratchet and Clank,20000000,11813410,8813410,-8186590,2010
2016-04-29,2861,Keanu,15000000,20609977,20591853,5609977,2010
2016-05-01,5007,Adulterers,750000,0,0,-750000,2010
2016-05-02,878,Xi You Ji zhi Sun Wu Kong San Da Bai Gu Jing,60000000,194058503,709982,134058503,2010
2016-05-02,1920,Pride and Prejudice and Zombies,28000000,16311335,10907291,-11688665,2010
2016-05-02,2248,"Hail, Caesar!",22000000,64171419,30080225,42171419,2010
2016-05-02,3285,Misconduct,11000000,2124005,0,-8875995,2010
2016-05-08,85,Suicide Squad,175000000,746100054,325100054,571100054,2010
2016-05-08,3094,Operation Chromite,12700000,49196532,1022720,36496532,2010
2016-05-13,1944,Money Monster,27000000,93469699,41012075,66469699,2010
2016-05-13,4183,The Darkness,4000000,10898293,10753574,6898293,2010
2016-05-20,619,The Angry Birds Movie,73000000,352829528,107509366,279829528,2010
2016-05-20,1070,The Nice Guys,50000000,57261763,36261763,7261763,2010
2016-05-20,1539,Neighbors 2: Sorority Rising,35000000,108758521,55340730,73758521,2010
2016-05-24,5291,Une Femme Mariée,120000,0,0,-120000,2010
2016-05-27,81,X-Men: Apocalypse,178000000,542742489,155442489,364742489,2010
2016-05-27,106,Alice Through the Looking Glass,170000000,277442381,77042381,107442381,2010
2016-06-05,11,Captain America: Civil War,250000000,1151684349,408084349,901684349,2010
2016-06-05,3549,Dheepan,9000000,7714549,248795,-1285451,2010
2016-06-05,3672,Code of Honor,8000000,0,0,-8000000,2010
2016-06-12,3779,Oddball,7000000,10237239,0,3237239,2010
2016-06-17,39,Finding Dory,200000000,1022617376,486295561,822617376,2010
2016-06-17,1011,Central Intelligence,50000000,217196811,127440871,167196811,2010
2016-06-24,113,Independence Day: Resurgence,165000000,387644286,103144286,222644286,2010
2016-06-24,1095,Free State of Jones,50000000,23152062,20810036,-26847938,2010
2016-06-24,3039,The Shallows,13000000,118888025,55121623,105888025,2010
2016-06-24,3691,The Neon Demon,7500000,3559803,1333124,-3940197,2010
2016-06-24,4373,Swiss Army Man,3000000,5100863,4210454,2100863,2010
2016-06-24,4482,Hunt for the Wilderpeople,2500000,23014021,5205471,20514021,2010
2016-06-30,2520,Fight Valley,20000000,0,0,-20000000,2010
2016-07-10,1174,The Girl on the Train,45000000,170327930,75395035,125327930,2010
2016-07-10,3372,The Birth of a Nation,10000000,16084310,15861566,6084310,2010
2016-07-10,3575,Middle School: The Worst Years of My Life,8500000,23311425,20007149,14811425,2010
2016-07-13,1141,The Infiltrator,47500000,18329653,15436808,-29170347,2010
2016-07-15,179,Ghostbusters,144000000,229034050,128350574,85034050,2010
2016-07-15,4008,Hillary’s America: The Secret History of the Democratic Party,5000000,13099931,13099931,8099931,2010
2016-07-22,71,Star Trek Beyond,185000000,336398312,158848340,151398312,2010
2016-07-22,316,Ice Age: Collision Course,105000000,403841637,64063008,298841637,2010
2016-07-22,3960,Lights Out,5000000,148868835,67268835,143868835,2010
2016-07-22,4372,Don’t Think Twice,3000000,4417983,4417983,1417983,2010
2016-07-27,2354,Nerve,20000000,61680792,38583626,41680792,2010
2016-07-29,256,Jason Bourne,120000000,416197059,162192920,296197059,2010
2016-07-29,2317,Bad Moms,20000000,181457297,113257297,161457297,2010
2016-08-01,201,The Revenant,135000000,532950503,183637894,397950503,2010
2016-08-01,3348,The Forest,10000000,40055439,26594261,30055439,2010
2016-08-01,4288,The Masked Saint,3500000,182695,182695,-3317305,2010
2016-08-03,1859,Savva. Serdtse voyna,30000000,1769316,0,-28230684,2010
2016-08-04,1866,The Boss,29000000,78652395,63077560,49652395,2010
2016-08-04,4897,The Invitation,1000000,354836,231738,-645164,2010
2016-08-07,572,The Secret Life of Pets,75000000,875958307,368384330,800958307,2010
2016-08-07,1646,Mike and Dave Need Wedding Dates,33000000,75909673,46009673,42909673,2010
2016-08-07,4645,The Wrong Side of Right,2000000,0,0,-2000000,2010
2016-08-19,380,Ben-Hur,95000000,88725100,26410477,-6274900,2010
2016-08-19,943,Kubo and the Two Strings,55000000,74545591,48023088,19545591,2010
2016-08-19,1059,War Dogs,50000000,83034523,43034523,33034523,2010
2016-08-26,2480,Hands of Stone,20000000,4754517,4712792,-15245483,2010
2016-08-26,3305,Don’t Breathe,10000000,158185073,89217875,148185073,2010
2016-08-26,3542,Greater,9000000,2000093,2000093,-6999907,2010
2016-09-09,781,Sully,60000000,238552082,125070033,178552082,2010
2016-09-09,3341,When the Bough Breaks,10000000,30629507,29747603,20629507,2010
2016-09-09,3457,Kicks,10000000,150191,150191,-9849809,2010
2016-09-12,1187,Office Christmas Party,45000000,91342494,54767494,46342494,2010
2016-09-12,2311,La La Land,20000000,433574208,151101803,413574208,2010
2016-09-16,1093,Snowden,50000000,34301950,21587519,-15698050,2010
2016-09-16,1579,Bridget Jones’s Baby,35000000,203555567,24139805,168555567,2010
2016-09-16,3356,Blair Witch,10000000,37493221,20777061,27493221,2010
2016-09-23,410,The Magnificent Seven,90000000,159762983,93427848,69762983,2010
2016-09-23,655,Storks,70000000,174102281,72679278,104102281,2010
2016-09-23,3232,The Dressmaker,11900000,24041617,2022115,12141617,2010
2016-09-30,127,Deepwater Horizon,156000000,113611666,61433527,-42388334,2010
2016-09-30,296,Miss Peregrine’s Home for Peculiar Children,110000000,296642834,87242834,186642834,2010
2016-10-06,125,Warcraft,160000000,433125655,47225655,273125655,2010
2016-10-06,421,Now You See Me 2,90000000,328675540,65075540,238675540,2010
2016-10-06,1290,The Conjuring 2: The Enfield Poltergeist,40000000,311270008,102470008,271270008,2010
2016-10-06,2709,Genius,17000000,5653176,1361045,-11346824,2010
2016-10-14,1301,The Accountant,40000000,153060045,86260045,113060045,2010
2016-10-14,3353,Kevin Hart: What Now?,10000000,23591043,23591043,13591043,2010
2016-10-16,4536,Mi America,2100000,3330,3330,-2096670,2010
2016-10-21,816,Jack Reacher: Never Go Back,60000000,160038407,58697076,100038407,2010
2016-10-21,2326,Tyler Perry’s Boo! A Madea Halloween,20000000,73206343,73206343,53206343,2010
2016-10-21,3517,Ouija: Origin of Evil,9000000,81831866,35144505,72831866,2010
2016-10-21,4707,Moonlight,1500000,55800987,27854931,54300987,2010
2016-10-21,4723,I’m Not Ashamed,1500000,2082980,2082980,582980,2010
2016-10-28,608,Inferno,75000000,219572877,34355263,144572877,2010
2016-11-03,1615,The Brothers Grimsby,35000000,28721408,6864016,-6278592,2010
2016-11-03,2714,The Young Messiah,16800000,7313697,6469813,-9486303,2010
2016-11-03,3060,Eye in the Sky,13000000,34916128,18704596,21916128,2010
2016-11-03,3959,10 Cloverfield Lane,5000000,108286422,72082999,103286422,2010
2016-11-03,4021,The Perfect Match,5000000,9669521,9669521,4669521,2010
2016-11-03,4906,Creative Control,1000000,63014,63014,-936986,2010
2016-11-11,1143,Arrival,47000000,203178872,100546139,156178872,2010
2016-11-11,1423,Billy Lynn’s Long Halftime Walk,40000000,25863458,1738477,-14136542,2010
2016-11-11,1433,USS Indianapolis: Men of Courage,40000000,1079040,0,-38920960,2010
2016-11-11,2680,Almost Christmas,17000000,42141196,42065185,25141196,2010
2016-11-11,3401,Shut In,10000000,8457974,6900335,-1542026,2010
2016-11-18,74,Fantastic Beasts and Where to Find Them,180000000,803798342,234037575,623798342,2010
2016-11-18,2229,Nocturnal Animals,22500000,30719170,10663357,8219170,2010
2016-11-18,2519,The History of Love,20000000,0,0,-20000000,2010
2016-11-18,2761,Bleed for This,16000000,6248077,5083906,-9751923,2010
2016-11-18,3527,The Edge of Seventeen,9000000,18802255,14431633,9802255,2010
2016-11-18,3567,Manchester by the Sea,8500000,75740479,47695371,67240479,2010
2016-11-18,3659,A Street Cat Named Bob,8000000,8370555,82703,370555,2010
2016-11-23,141,Moana,150000000,639537208,248757044,489537208,2010
2016-11-23,1965,Rules Don’t Apply,26700000,3871448,3652206,-22828552,2010
2016-11-25,2635,Miss Sloane,18000000,5823540,3500605,-12176460,2010
2016-11-25,3138,Lion,12000000,145712897,51728731,133712897,2010
2016-12-02,567,The Little Prince,77500000,90905178,1311213,13405178,2010
2016-12-02,881,Deadpool,58000000,801029249,363070709,743029249,2010
2016-12-02,1078,Zoolander 2,50000000,55348693,28848693,5348693,2010
2016-12-02,1483,How to be Single,37000000,99595932,46843513,62595932,2010
2016-12-08,725,Pete’s Dragon,65000000,137768975,76233151,72768975,2010
2016-12-08,1870,Florence Foster Jenkins,29000000,44267641,27383770,15267641,2010
2016-12-08,2531,Sausage Party,19000000,140428314,97670358,121428314,2010
2016-12-08,3154,Hell or High Water,12000000,37584304,27007844,25584304,2010
2016-12-16,38,Rogue One: A Star Wars Story,200000000,1050988488,532177324,850988488,2010
2016-12-16,1497,Collateral Beauty,36000000,85315070,31016021,49315070,2010
2016-12-21,250,Assassin’s Creed,125000000,240497948,54647948,115497948,2010
2016-12-21,294,Passengers,110000000,302211243,100014092,192211243,2010
2016-12-21,574,Sing,75000000,627886287,270329045,552886287,2010
2016-12-21,1367,Patriots Day,40000000,44383030,31886361,4383030,2010
2016-12-23,1151,Silence,46500000,16149791,7100177,-30350209,2010
2016-12-23,1452,Why Him?,38000000,117523786,60323786,79523786,2010
2016-12-25,751,Live by Night,65000000,21778555,10378555,-43221445,2010
2016-12-25,2010,Hidden Figures,25000000,229518131,169374490,204518131,2010
2016-12-31,2162,Reagan,25000000,0,0,-25000000,2010
2016-12-31,2277,The Butterfly God,22000000,0,0,-22000000,2010
2016-12-31,4147,Airlift (2016),4400000,9969237,0,5569237,2010
2016-12-31,4948,Chemical Cut,1000000,0,0,-1000000,2010
2016-12-31,5105,Crabs!,500000,0,0,-500000,2010
2017-01-09,4504,Sky Sharks,2500000,0,0,-2500000,2010
2017-01-13,251,Monster Trucks,125000000,61681268,33370166,-63318732,2010
2017-01-13,3699,The Bye Bye Man,7400000,25863405,22395806,18463405,2010
2017-01-20,466,xXx: Return of Xander Cage,85000000,345114933,44898413,260114933,2010
2017-01-20,2880,The Founder,15000000,18301418,12786243,3301418,2010
2017-01-20,3955,Split,5000000,276841585,138141585,271841585,2010
2017-01-27,1379,Resident Evil: The Final Chapter,40000000,307353906,26844692,267353906,2010
2017-01-27,2032,A Dog’s Purpose,25000000,189922583,64321890,164922583,2010
2017-01-27,5355,Emily,27000,3547,3547,-23453,2010
2017-01-31,3791,Two Lovers and a Bear,6840000,22273,0,-6817727,2010
2017-02-06,135,Wonder Woman,150000000,785964691,395674792,635964691,2010
2017-02-06,1449,Captain Underpants: The First Epic Movie,38000000,87098466,72498466,49098466,2010
2017-02-17,168,The Great Wall,150000000,331775766,45157105,181775766,2010
2017-02-17,2071,Fist Fight,25000000,40287017,32187017,15287017,2010
2017-02-17,2946,In Dubious Battle,15000000,4892,0,-14995108,2010
2017-02-24,874,Rock Dog,60000000,20830546,9420546,-39169454,2010
2017-02-24,1863,Collide,29200000,5278519,2280004,-23921481,2010
2017-02-24,2301,Bitter Harvest,21000000,606162,557241,-20393838,2010
2017-02-24,3954,Get Out,5000000,251359904,175484140,246359904,2010
2017-03-02,2080,Rings,25000000,82991460,27793018,57991460,2010
2017-03-02,4608,Growing up Smith,2000000,35312,35312,-1964688,2010
2017-03-03,229,Logan,127000000,615577068,226277068,488577068,2010
2017-03-17,115,Beauty and the Beast,160000000,1260122363,504014165,1100122363,2010
2017-03-17,2639,T2: Trainspotting,18000000,42067430,2395410,24067430,2010
2017-03-17,4020,The Belko Experiment,5000000,10744134,10166820,5744134,2010
2017-03-24,263,Power Rangers,120000000,140845191,85364450,20845191,2010
2017-03-24,891,Life,58000000,100993260,30223972,42993260,2010
2017-03-24,2094,CHiPS,25000000,23190697,18600152,-1809303,2010
2017-03-31,242,The Boss Baby,125000000,492557218,174678355,367557218,2010
2017-03-31,306,Ghost in the Shell,110000000,167918847,40563557,57918847,2010
2017-04-08,879,The Dark Tower,60000000,0,0,-60000000,2010
2017-04-14,18,The Fate of the Furious,250000000,1237444462,225764765,987444462,2010
2017-04-14,1506,Queen of the Desert,36000000,1480089,0,-34519911,2010
2017-04-21,432,The Promise,90000000,10020889,8224288,-79979111,2010
2017-04-21,3180,Unforgettable,12000000,15668012,11368012,3668012,2010
2017-04-21,3429,Free Fire,10000000,3565109,1799322,-6434891,2010
2017-04-28,1812,Baahubali 2: The Conclusion,30000000,184075552,18985794,154075552,2010
2017-04-28,2498,Jìyì dàshī,20000000,43326383,587470,23326383,2010
2017-04-28,2603,The Circle,18000000,33907844,20497844,15907844,2010
2017-05-05,42,Guardians of the Galaxy Vol 2,200000000,858470006,387805844,658470006,2010
2017-05-05,2225,Chāi dàn zhuānjiā,23000000,58807172,0,35807172,2010
2017-05-19,2253,Diary of a Wimpy Kid: The Long Haul,22000000,35409686,20710572,13409686,2010
2017-05-19,3329,"Everything, Everything",10000000,45921140,34121140,35921140,2010
2017-05-25,817,Baywatch,60000000,169740988,58060186,109740988,2010
2017-05-26,20,Pirates of the Caribbean: Dead Men Tell No Tales,230000000,776037086,171037086,546037086,2010
2017-06-01,1244,A Monster Calls,43000000,45095823,3740823,2095823,2010
2017-06-16,1197,All Eyez on Me,45000000,54855235,44900235,9855235,2010
2017-06-16,2397,Rough Night,20000000,41015970,21906917,21015970,2010
2017-06-21,27,Transformers: The Last Knight,217000000,568923844,128866562,351923844,2010
2017-06-28,1634,Baby Driver,34000000,139359078,92558357,105359078,2010
2017-06-30,575,Despicable Me 3,75000000,823755831,231351340,748755831,2010
2017-06-30,1383,The House,40000000,30576502,24938902,-9423498,2010
2017-07-03,4832,Departure,1100000,27561,0,-1072439,2010
2017-07-04,834,Smurfs: The Lost Village,60000000,197242826,45011202,137242826,2010
2017-07-04,2171,Going in Style,24000000,78714211,45018541,54714211,2010
2017-07-07,87,Spider-Man: Homecoming,175000000,638087983,279991585,463087983,2010
2017-07-14,131,War for the Planet of the Apes,152000000,225986078,120086079,73986078,2010
2017-07-14,3174,Wish Upon,12000000,19379463,12929463,7379463,2010
2017-07-21,79,Valerian and the City of a Thousand Planets,180000000,52573132,31023132,-127426868,2010
2017-07-21,162,Dunkirk,150000000,235907054,104641608,85907054,2010
2017-07-21,1890,Girls Trip,28000000,69290699,67206670,41290699,2010
2017-07-28,1081,The Emoji Movie,50000000,27366288,27365212,-22633712,2010
2017-07-28,1808,Atomic Blonde,30000000,23095325,20095325,-6904675,2010
2017-07-28,4901,An Inconvenient Sequel,1000000,130874,130874,-869126,2010
2017-08-25,1856,Ballerina,30000000,48048527,0,18048527,2010
2017-08-25,2161,Tulip Fever,25000000,0,0,-25000000,2010
2017-08-25,4237,Polina danser sa vie,4000000,36630,0,-3963370,2010
2017-09-06,57,The Mummy,195000000,397644453,79741080,202644453,2010
2017-09-06,4004,It Comes at Night,5000000,17250101,13845101,12250101,2010
2017-10-02,489,The Lego Batman Movie,80000000,310940997,175750384,230940997,2010
2017-10-02,914,Fifty Shades Darker,55000000,376856949,114434010,321856949,2010
2017-10-02,1295,John Wick: Chapter Two,40000000,166893990,92029184,126893990,2010
2017-10-03,70,Kong: Skull Island,185000000,561137727,168052812,376137727,2010
2017-12-05,94,King Arthur: Legend of the Sword,175000000,140012608,39175066,-34987392,2010
2017-12-05,1254,Snatched,42000000,57850343,45850343,15850343,2010
2017-12-31,2521,The Thousand Miles,20000000,0,0,-20000000,2010
